ID,PHI,K,TP,TN,FP,FN,NHAM,NSPAM
677,2.103003559,0.821188932,565,551,0,19,565,570
767,1.140894673,1.568071555,882,855,1,28,883,883
672,3.032052642,0.7119040237,914,940,1,39,915,979
789,3.627197515,0.1008787384,784,771,1,24,785,795
629,1.033468418,0.2739749317,571,571,1,13,572,584
405,1.647332133,0.9765124974,875,799,1,42,876,841
589,2.320435805,2.683048521,937,952,1,70,938,1022
673,2.005470316,1.195278406,1207,1118,2,42,1209,1160
387,4.974410212,0.7639293287,693,663,1,38,694,701
421,3.791435993,1.26864889,681,656,1,40,682,696
740,3.011170332,2.63999694,639,668,1,49,640,717
662,2.545044878,1.188666514,966,920,2,36,968,956
686,2.252911173,1.209756887,905,846,2,35,907,881
638,3.408962414,2.385869707,1552,1457,3,94,1555,1551
667,4.439473754,0.9286344237,936,936,2,57,938,993
401,4.428382529,1.68817178,875,877,2,46,877,923
502,2.861991446,2.454822908,899,847,2,41,901,888
545,4.6556985,0.9231060548,571,530,1,41,572,571
748,4.60442962,0.03401566458,1465,1440,4,40,1469,1480
452,1.91131278,2.350668789,1354,1329,3,80,1357,1409
533,1.541440629,0.4736891703,751,745,2,29,753,774
746,3.441408693,1.358726204,796,730,2,30,798,760
656,2.256861636,0.7653461081,1111,1031,3,34,1114,1065
641,2.940478688,0.8148459387,651,660,2,17,653,677
532,2.423055629,2.25286147,1537,1523,4,79,1541,1602
453,2.144187121,1.421820281,763,759,2,39,765,798
435,2.171976469,0.4436921463,715,673,2,21,717,694
606,4.83286437,0.7039853199,834,748,2,37,836,785
378,4.742438018,0.5631056206,1403,1369,4,55,1407,1424
400,4.860118678,1.508384892,1260,1249,3,90,1263,1339
593,2.476605148,2.012057888,1164,1087,3,56,1167,1143
396,2.176209628,1.081585966,1343,1338,4,52,1347,1390
625,3.031753257,2.323660109,794,726,2,40,796,766
411,4.220608787,0.7154254487,690,660,2,27,692,687
569,3.644759866,1.886404708,782,730,2,44,784,774
437,3.21634471,0.3031732565,985,945,3,34,988,979
505,3.230699538,0.1363291007,1183,1213,4,35,1187,1248
705,4.74428011,2.141846804,1210,1119,3,76,1213,1195
479,2.52368742,0.1932091521,875,919,3,30,878,949
707,4.364336397,0.1690139032,1267,1221,4,39,1271,1260
490,1.10051054,0.8689296956,913,889,3,24,916,913
529,4.521656709,2.102782644,1107,1019,3,58,1110,1077
507,1.926128411,1.337696899,551,620,2,27,553,647
572,3.030898757,2.381922956,738,632,2,30,740,662
373,1.557535481,1.235010703,1134,1187,4,43,1138,1230
580,1.239746909,0.7115975928,897,869,3,29,900,898
781,1.460110857,1.185719922,1564,1528,5,70,1569,1598
353,4.516365408,1.952401003,714,657,2,41,716,698
785,2.94795915,1.782944245,1085,1018,3,71,1088,1089
415,2.065786103,0.5393634863,900,860,3,33,903,893
513,1.569199439,2.975114265,803,704,2,56,805,760
554,2.012127227,1.003931653,1168,1132,4,41,1172,1173
708,3.870986582,1.18688435,697,617,2,34,699,651
591,4.548087944,2.636691536,665,667,2,47,667,714
687,3.218979518,1.032005296,568,582,2,25,570,607
422,4.667123498,1.21494142,1029,955,3,59,1032,1014
404,2.740098174,0.7559473281,1163,1155,4,52,1167,1207
456,3.765761806,2.154735801,570,614,2,36,572,650
594,2.384226735,1.482537722,1569,1535,5,90,1574,1625
474,1.127082677,0.9908084422,1163,1125,4,46,1167,1171
652,2.451610656,0.8559935901,1203,1160,4,58,1207,1218
403,4.538098591,1.033957723,582,564,2,26,584,590
468,3.941314545,1.60600468,908,827,3,34,911,861
794,2.313174058,0.3242013404,1399,1370,5,55,1404,1425
470,3.171838156,2.389222774,989,921,3,60,992,981
504,1.321530089,0.5543783537,778,807,3,29,781,836
756,2.062498409,2.95391383,1357,1274,4,93,1361,1367
483,4.262472186,1.705252159,647,613,2,40,649,653
360,4.790553797,2.214021924,1271,1247,4,86,1275,1333
472,2.286396358,0.8095784024,775,790,3,27,778,817
335,3.444986441,2.669210707,1361,1328,4,114,1365,1442
476,3.682265977,0.1754316247,1609,1556,6,51,1615,1607
457,1.842097897,1.219544178,1655,1599,6,70,1661,1669
567,2.632797155,0.4492905931,594,572,2,36,596,608
757,3.672765612,1.850964489,1187,1089,4,58,1191,1147
384,4.251706636,1.168451366,1442,1323,5,62,1447,1385
706,1.909880256,2.213408872,954,795,3,38,957,833
605,4.168011964,2.023387875,996,904,3,70,999,974
395,2.180973498,1.533524831,1040,1078,4,57,1044,1135
784,2.171665339,2.867793196,577,568,2,39,579,607
454,2.492580606,2.193028214,1401,1359,5,83,1406,1442
439,1.144514144,1.523435103,1497,1444,6,47,1503,1491
342,3.134579639,1.927003067,1338,1314,5,74,1343,1388
649,3.531512082,0.07437778213,1191,1156,5,28,1196,1184
747,2.984210094,1.672384196,1357,1324,5,81,1362,1405
680,3.584642316,1.47665666,1283,1266,5,66,1288,1332
417,3.126134854,1.333963842,1473,1473,6,65,1479,1538
723,4.297802136,0.361297134,788,744,3,35,791,779
679,3.824503095,2.462276449,1087,1064,4,70,1091,1134
699,4.511870896,1.45542347,1291,1270,5,69,1296,1339
521,4.348923712,0.4600315126,1012,963,4,40,1016,1003
441,4.286288211,1.093579128,1131,1031,4,63,1135,1094
655,4.095187252,0.2273286813,1264,1209,5,55,1269,1264
796,4.3110856,0.926463209,1601,1485,6,79,1607,1564
734,1.510363503,2.088209722,939,973,4,49,943,1022
650,2.019111376,2.461599218,1010,942,4,40,1014,982
703,1.579773619,0.6695692671,705,678,3,21,708,699
803,4.529588574,1.082768627,1551,1477,6,82,1557,1559
671,1.191625588,0.3977321467,1404,1367,6,47,1410,1414
419,2.399375069,2.378740228,1581,1506,6,93,1587,1599
450,1.290829165,2.439645701,994,939,4,41,998,980
497,3.446063771,0.4713273784,1434,1376,6,53,1440,1429
322,1.498403945,1.48630058,1315,1360,6,48,1321,1408
583,1.506390429,0.3294226395,876,899,4,30,880,929
426,2.910466776,1.697074364,791,703,3,32,794,735
599,1.285970513,0.2203619339,670,666,3,20,673,686
546,2.9554639,2.02876744,1345,1225,5,73,1350,1298
333,3.765935448,2.063291832,835,730,3,43,838,773
518,4.010003516,1.70369876,1262,1199,5,66,1267,1265
674,3.208872523,0.1854856762,1198,1108,5,36,1203,1144
799,4.52900563,1.949473504,1393,1320,5,107,1398,1427
659,2.446293849,2.683934228,1382,1299,5,100,1387,1399
610,2.321010916,1.764566437,952,913,4,39,956,952
443,4.093364256,2.90044357,1095,999,4,68,1099,1067
678,3.304350526,0.3297742691,1433,1329,6,46,1439,1375
330,4.979724184,1.230108862,1093,968,4,59,1097,1027
524,4.161270485,2.335050847,1615,1497,6,105,1621,1602
604,4.124474637,1.20828722,1146,1156,5,57,1151,1213
339,4.999932456,0.2302422316,880,855,4,22,884,877
721,4.217635939,0.1137257878,1358,1296,6,38,1364,1334
363,2.946927428,1.426178435,1366,1388,6,71,1372,1459
729,2.29025331,1.55886467,1235,1122,5,48,1240,1170
713,3.803423453,0.1087581189,1618,1542,7,59,1625,1601
361,2.817212144,2.23813334,1266,1190,5,75,1271,1265
392,2.877338738,1.061842232,1194,1130,5,55,1199,1185
791,4.237889265,2.093212874,1037,971,4,71,1041,1042
793,3.678085649,1.583057582,1165,1157,5,69,1170,1226
558,3.415023449,0.5817462837,734,645,3,26,737,671
630,3.396836269,1.996904087,1014,1108,5,56,1019,1164
380,3.784225823,2.353257758,1538,1388,6,90,1544,1478
754,1.559417902,1.640924864,1153,1102,5,56,1158,1158
394,3.673318066,1.711413647,1304,1153,5,75,1309,1228
581,1.975774106,2.917740379,1463,1371,6,86,1469,1457
555,2.087350488,2.260331999,1188,1104,5,58,1193,1162
402,4.284018695,0.1178673351,825,814,4,22,829,836
798,4.956625519,2.136841374,1236,1198,5,93,1241,1291
579,4.023344648,1.265470059,1129,1119,5,65,1134,1184
344,1.017214351,0.4255240157,967,1013,5,28,972,1041
489,1.87925924,0.4248708472,875,837,4,33,879,870
316,2.124826921,1.94668924,1562,1487,7,67,1569,1554
612,1.29734013,1.248171833,1102,1059,5,47,1107,1106
766,1.206681446,2.454767759,1588,1492,7,70,1595,1562
399,2.504339175,1.343851215,1264,1262,6,54,1270,1316
804,1.018766704,1.987401369,823,791,4,20,827,811
480,4.370484297,1.241962745,1390,1279,6,66,1396,1345
467,3.917853879,0.7221137601,724,657,3,40,727,697
449,3.421052894,2.031428473,1517,1391,6,111,1523,1502
447,2.335144841,0.5593040764,1460,1432,7,58,1467,1490
697,3.217150028,1.776286332,978,896,4,63,982,959
694,1.292739554,0.5143410619,1401,1368,7,35,1408,1403
312,4.605530149,2.108950407,1186,1125,5,82,1191,1207
743,4.715299646,2.532197249,1390,1326,6,95,1396,1421
608,1.536752924,0.8593384219,957,990,5,35,962,1025
485,4.281159932,2.147587085,1461,1341,6,101,1467,1442
733,3.667999749,0.9613352287,1327,1197,6,48,1333,1245
783,3.041058473,2.253129284,1169,1100,5,81,1174,1181
642,2.55685142,1.131657935,1281,1215,6,58,1287,1273
716,1.633729687,1.776938541,916,814,4,42,920,856
308,1.842563241,2.5677658,925,825,4,47,929,872
553,3.588470029,1.635095916,1381,1284,6,89,1387,1373
717,1.900790136,1.812346039,1114,1001,5,47,1119,1048
559,4.054063049,1.136668535,1155,1028,5,59,1160,1087
525,1.378914997,1.17871179,1125,1165,6,44,1131,1209
624,4.755521789,2.58701715,1592,1484,7,101,1599,1585
393,3.297043883,0.9796836222,1360,1378,7,60,1367,1438
541,2.913202891,1.414316394,1096,1014,5,55,1101,1069
648,2.818641375,0.2417877184,1155,1130,6,32,1161,1162
755,2.752350363,2.735883026,1294,1224,6,71,1300,1295
788,4.858370411,1.49511438,1489,1428,7,84,1496,1512
637,4.340323995,0.1651902072,576,567,3,18,579,585
759,2.46652864,1.877589614,1153,1186,6,59,1159,1245
528,2.978836462,1.039846563,1147,1160,6,50,1153,1210
750,2.893480999,0.8058975618,1573,1569,8,76,1581,1645
574,3.033809154,0.5350859955,786,765,4,34,790,799
645,2.987091294,2.450839015,1283,1208,6,77,1289,1285
617,3.218080246,2.221542357,1071,1047,5,81,1076,1128
440,3.003000016,2.865858196,1585,1466,7,115,1592,1581
547,3.890359486,2.212627679,599,595,3,38,602,633
382,3.034959404,2.430378816,1228,1208,6,84,1234,1292
368,2.447796988,2.456955777,1159,1178,6,72,1165,1250
307,4.088586865,1.293652459,1456,1508,8,71,1464,1579
462,1.171743719,1.964271771,1190,1121,6,49,1196,1170
534,1.21280872,2.340676715,764,769,4,43,768,812
375,4.562404376,2.707940038,587,585,3,36,590,621
319,4.903976353,2.236520196,1276,1197,6,88,1282,1285
636,3.913765266,2.625408524,1267,1183,6,82,1273,1265
690,4.549331401,0.810275297,1190,1106,6,50,1196,1156
341,3.345230122,0.6804289825,877,913,5,38,882,951
633,4.652898156,2.84649419,1490,1411,7,115,1497,1526
311,1.553893042,1.808568667,789,752,4,42,793,794
551,2.738891298,2.992545183,1600,1564,8,111,1608,1675
460,2.943744875,2.072554653,1558,1516,8,91,1566,1607
738,4.730854201,1.698796852,1015,935,5,53,1020,988
503,1.875794453,2.957023694,1346,1304,7,73,1353,1377
516,2.550735736,1.335722789,623,550,3,28,626,578
386,1.202254531,2.978843557,1113,1126,6,68,1119,1194
364,1.524200962,1.78580064,1167,1085,6,51,1173,1136
367,4.440798927,1.627153511,756,741,4,42,760,783
571,1.194973747,1.374222182,1439,1421,8,59,1447,1480
436,4.02991775,2.770146519,813,767,4,55,817,822
526,2.213846792,2.103648633,791,735,4,41,795,776
346,3.886766322,2.71920088,610,574,3,41,613,615
780,4.219374584,1.037103618,1464,1274,7,72,1471,1346
494,2.026770547,2.102760795,1578,1466,8,87,1586,1553
309,1.195358528,1.544295363,1095,1050,6,43,1101,1093
725,2.922994644,1.113629059,885,858,5,31,890,889
356,3.047658192,2.220468451,1423,1437,8,80,1431,1517
550,4.873332908,0.8521938905,1053,1049,6,47,1059,1096
557,4.84945677,2.136297503,1556,1473,8,103,1564,1576
710,2.884721421,1.452066915,876,849,5,31,881,880
712,4.008345537,2.342439275,958,907,5,59,963,966
565,2.816924387,1.053806096,900,860,5,37,905,897
777,2.157983088,0.4393477645,1532,1540,9,63,1541,1603
430,4.503589256,1.202122925,1102,1084,6,69,1108,1153
424,4.684057812,1.642010015,1254,1255,7,78,1261,1333
496,1.706907684,1.387678808,1546,1547,9,70,1555,1617
585,3.983712783,1.104327547,1579,1550,9,75,1588,1625
520,2.754560181,2.18465025,618,548,3,40,621,588
587,2.175798795,0.8510175667,1272,1200,7,57,1279,1257
329,1.102607951,1.597804473,1419,1351,8,56,1427,1407
769,3.439730498,0.4232794646,664,674,4,28,668,702
540,1.41266314,1.414276426,1561,1514,9,62,1570,1576
778,1.752406024,1.5291961,1595,1516,9,63,1604,1579
749,2.744449578,1.057006895,1076,1026,6,52,1082,1078
763,2.930526181,2.01818928,651,701,4,43,655,744
611,1.252381207,0.493655649,829,810,5,24,834,834
414,1.459502082,2.784308357,1581,1530,9,79,1590,1609
578,2.747566854,1.00345454,1279,1157,7,46,1286,1203
451,3.416295175,1.565225841,881,852,5,46,886,898
722,2.69044602,1.252895646,1550,1401,8,94,1558,1495
416,2.416285854,0.3889455124,1208,1151,7,46,1215,1197
665,1.028362858,2.178876735,875,827,5,36,880,863
692,2.963595716,1.159349305,1356,1336,8,65,1364,1401
566,4.616534893,0.8037848859,1226,1153,7,50,1233,1203
590,2.023109618,2.263192198,1049,1038,6,69,1055,1107
634,1.803160472,0.9360129406,1562,1487,9,71,1571,1558
635,3.885735262,0.4963286084,910,839,5,46,915,885
586,1.926404461,1.649346067,1374,1336,8,71,1382,1407
620,1.452927881,0.5692479969,1494,1423,9,42,1503,1465
719,2.088482198,2.496261869,1111,1163,7,62,1118,1225
582,1.47269772,1.404661663,1475,1466,9,66,1484,1532
530,3.470642014,2.240095475,1080,1020,6,67,1086,1087
663,1.825538995,2.094299755,715,648,4,30,719,678
362,4.568929976,2.546814398,576,527,3,44,579,571
323,3.526613967,0.2871205286,1055,1114,7,44,1062,1158
306,3.680707448,2.326060348,847,819,5,44,852,863
616,1.166342617,0.3806149437,1083,1073,7,24,1090,1097
654,1.619278005,1.7099813,1001,949,6,38,1007,987
517,4.211419833,1.952116623,1101,1016,6,73,1107,1089
563,3.016923764,2.172499411,1401,1356,8,99,1409,1455
413,3.83003439,2.019501651,934,976,6,53,940,1029
442,3.238010105,0.07803097511,942,947,6,38,948,985
390,3.998104497,1.164589435,997,955,6,43,1003,998
603,1.158132872,2.266354782,1261,1262,8,52,1269,1314
510,1.200672397,2.786122708,1293,1299,8,73,1301,1372
320,1.764629887,2.591350559,1125,1133,7,62,1132,1195
325,4.552926314,1.269070783,1608,1446,9,75,1617,1521
523,2.746705322,0.2251640144,999,946,6,41,1005,987
391,4.845804046,2.402264276,1300,1330,8,91,1308,1421
389,2.368574914,2.754205794,712,637,4,31,716,668
508,3.810507232,1.679152029,1480,1462,9,85,1489,1547
348,3.651880923,0.3501043155,1477,1395,9,51,1486,1446
761,2.881387045,0.7333782117,1245,1249,8,51,1253,1300
377,2.289598702,0.3052804489,1578,1532,10,49,1588,1581
666,3.080351798,2.24276433,878,810,5,48,883,858
410,3.401497246,1.28944377,919,798,5,42,924,840
326,4.860672914,2.504572956,1462,1355,8,109,1470,1464
622,1.18341073,2.671513936,775,780,5,35,780,815
561,4.400104899,1.296363098,710,648,4,41,714,689
709,3.507127093,2.622470076,885,815,5,54,890,869
432,4.284872085,0.7713587135,786,779,5,35,791,814
338,3.384488004,0.9907918222,1538,1551,10,70,1548,1621
752,1.931656312,1.619017068,1104,1113,7,64,1111,1177
570,4.491379231,0.3328960125,1374,1384,9,58,1383,1442
676,2.653635696,0.2638439874,1110,1051,7,35,1117,1086
552,2.447619963,1.76241241,802,777,5,40,807,817
619,3.195959195,0.3785386786,1280,1223,8,53,1288,1276
795,3.196696905,2.254460286,1543,1446,9,99,1552,1545
727,1.052342457,0.8383396765,837,884,6,22,843,906
715,1.502377099,1.292005778,1090,1085,7,56,1097,1141
609,2.677310775,0.613774478,603,613,4,29,607,642
381,2.288557572,2.45561845,709,647,4,48,713,695
501,2.692837467,2.821405609,1398,1276,8,87,1406,1363
695,2.379882999,1.557098099,771,743,5,25,776,768
408,2.132081885,2.708629489,1313,1240,8,69,1321,1309
420,3.1093653,0.822848774,1522,1363,9,60,1531,1423
506,2.121623566,0.8204703213,979,924,6,49,985,973
473,3.892848367,2.881189732,694,634,4,43,698,677
739,2.488805846,0.1814339974,888,875,6,22,894,897
577,1.667846728,0.2724062316,1565,1494,10,59,1575,1553
409,4.079859528,0.9251988228,776,738,5,25,781,763
724,2.527038409,0.5962848778,785,737,5,25,790,762
628,3.366254097,2.803459599,1190,1122,7,87,1197,1209
640,4.003568548,0.4929949874,1104,1047,7,45,1111,1092
736,3.391931034,0.8584512739,1300,1216,8,63,1308,1279
433,2.725852778,2.529537877,696,624,4,41,700,665
737,3.884426145,2.232980567,1252,1227,8,73,1260,1300
765,3.668797321,0.3336093831,1051,1025,7,38,1058,1063
336,4.581829851,0.6945933237,1594,1483,10,67,1604,1550
548,3.726913884,1.765551647,763,747,5,38,768,785
588,3.111194434,2.227491729,932,878,6,35,938,913
536,3.735317678,0.5550003329,578,605,4,36,582,641
726,4.799983637,1.171327046,1495,1367,9,85,1504,1452
684,4.75890824,0.409422773,1575,1445,10,54,1585,1499
688,2.838635935,1.092189714,611,575,4,20,615,595
459,3.301060773,2.078660693,781,768,5,54,786,822
696,1.271051912,1.318379838,1199,1156,8,45,1207,1201
352,3.512725956,2.647633655,1453,1396,9,108,1462,1504
549,2.592785172,0.2027606843,1562,1561,11,47,1573,1608
681,4.227091448,2.375489333,668,600,4,37,672,637
366,2.27369093,1.034227514,1162,1144,8,41,1170,1185
797,3.494624478,0.06242924237,1372,1399,10,33,1382,1432
428,1.15194293,0.5128551109,1278,1273,9,38,1287,1311
509,3.127533831,1.230532308,1530,1490,10,88,1540,1578
657,4.610496911,1.472991278,971,904,6,59,977,963
658,2.775501116,0.9138225096,583,581,4,27,587,608
458,4.520528336,0.3232938207,615,570,4,21,619,591
621,4.289095457,1.847123176,1583,1507,10,103,1593,1610
488,1.328224335,2.626079264,1384,1276,9,45,1393,1321
764,1.000657845,1.649160659,593,572,4,24,597,596
347,4.992496445,0.7045292221,1377,1414,10,53,1387,1467
388,3.746734089,2.478832002,1266,1196,8,82,1274,1278
464,4.891588152,1.965358837,1468,1363,9,103,1477,1466
768,4.282003439,0.8210611171,1074,1017,7,54,1081,1071
564,2.893683854,1.68905261,1283,1162,8,63,1291,1225
354,4.785800016,2.225628495,966,916,6,75,972,991
753,1.940418975,0.2104771955,606,558,4,18,610,576
379,4.832683622,0.01708627692,1598,1529,11,49,1609,1578
689,3.800715227,2.468640672,1024,895,6,65,1030,960
800,1.306599368,0.333375683,677,689,5,20,682,709
406,1.072924462,0.2614222141,1317,1232,9,31,1326,1263
623,1.856045685,0.05530903476,1121,1091,8,26,1129,1117
592,3.094223599,0.3872648066,1478,1402,10,58,1488,1460
728,4.60366063,0.1520446967,1508,1377,10,46,1518,1423
370,1.116447585,2.759609849,1156,1151,8,70,1164,1221
455,1.983129903,1.642651566,1331,1415,10,73,1341,1488
318,3.881810951,2.218706334,1085,1028,7,76,1092,1104
491,1.653953237,2.134840808,1661,1554,11,82,1672,1636
632,2.889740859,0.3316663395,568,550,4,21,572,571
602,2.03917635,1.571581594,1161,1139,8,67,1169,1206
317,4.597418622,2.228168425,994,872,6,62,1000,934
543,2.540393547,2.667035202,805,710,5,42,810,752
305,4.040727863,2.451330154,1047,1024,7,79,1054,1103
615,1.398503944,0.9504826612,866,833,6,41,872,874
431,1.737264062,0.5045797836,1396,1364,10,54,1406,1418
487,2.10386592,0.7519923592,1227,1240,9,59,1236,1299
745,4.812211361,1.693991653,574,564,4,36,578,600
355,2.916371641,1.669403221,625,567,4,38,629,605
358,3.72151429,0.5987809193,1285,1242,9,64,1294,1306
670,1.505528726,0.3723085868,972,930,7,31,979,961
466,3.201222084,0.04839661382,1636,1571,12,38,1648,1609
465,1.439533286,2.837786812,574,563,4,39,578,602
493,2.048344103,2.108941135,583,564,4,41,587,605
321,3.385824264,1.930841686,1275,1236,9,71,1284,1307
607,3.333323892,0.1590203111,1027,926,7,33,1034,959
600,4.701336912,2.074434941,1222,1132,8,87,1230,1219
359,2.468043466,1.089907996,1269,1187,9,41,1278,1228
535,3.569261921,2.506971377,1103,979,7,72,1110,1051
407,4.823940473,0.09675159695,1069,907,7,25,1076,932
573,3.583304033,2.228415905,1224,1103,8,76,1232,1179
423,3.591815631,1.991816852,1171,1093,8,70,1179,1163
544,2.070238944,0.9861537478,1379,1318,10,55,1389,1373
792,4.94579803,0.9228410903,1021,945,7,54,1028,999
337,4.87774112,2.147087483,875,825,6,57,881,882
647,3.251037475,1.469498269,1003,921,7,39,1010,960
512,1.56484578,0.09796238273,1211,1157,9,32,1220,1189
475,2.101367542,1.952534897,1181,1080,8,65,1189,1145
515,1.30845532,2.025452584,1093,1050,8,46,1101,1096
542,1.203125056,2.639909022,890,820,6,57,896,877
596,1.098694063,1.354255145,1045,1052,8,48,1053,1100
371,4.413470883,1.347751777,721,660,5,32,726,692
332,3.540382833,1.306101871,1229,1165,9,47,1238,1212
614,3.185083031,2.079212808,991,956,7,72,998,1028
327,3.81892771,0.9220432201,633,546,4,41,637,587
704,2.303859253,0.4394408109,800,759,6,22,806,781
682,1.916778227,0.09468705577,765,757,6,21,771,778
484,1.413403457,2.53190106,788,793,6,49,794,842
331,1.966142849,0.8416574892,1451,1418,11,66,1462,1484
646,4.125834345,0.7433654449,1404,1284,10,57,1414,1341
773,3.686704683,1.006979198,682,644,5,32,687,676
698,3.128941017,1.072873012,1226,1140,9,44,1235,1184
711,4.739194009,1.867902017,958,931,7,66,965,997
742,4.318663258,2.322957729,626,535,4,41,630,576
478,3.480998575,1.337731957,1016,1028,8,54,1024,1082
434,3.003742844,2.263702495,779,788,6,53,785,841
720,3.429000197,0.6226056312,1208,1144,9,53,1217,1197
639,3.699164741,0.6140351337,877,882,7,36,884,918
779,2.944098293,2.148618377,1362,1290,10,74,1372,1364
787,3.025287314,2.495567161,725,654,5,44,730,698
802,1.19492095,0.8921908781,1189,1128,9,45,1198,1173
477,1.604520887,2.896683075,1379,1287,10,77,1389,1364
495,4.346864192,2.877287796,879,805,6,71,885,876
751,4.419347697,0.5486668445,830,753,6,33,836,786
643,2.522463889,2.14836287,803,755,6,35,809,790
499,3.458355843,0.6679155364,772,746,6,29,778,775
560,2.182326795,0.4485639819,760,734,6,27,766,761
448,2.914612875,2.000576635,1531,1402,11,94,1542,1496
350,2.74830568,1.911135007,765,752,6,44,771,796
730,4.427176419,1.492138701,1176,1126,9,69,1185,1195
427,3.519756746,0.9613060114,1315,1229,10,70,1325,1299
469,2.053657168,1.608497748,995,947,8,28,1003,975
310,2.171662567,1.529208476,1293,1220,10,65,1303,1285
584,3.583118057,2.667933137,1640,1513,12,117,1652,1630
664,1.519511908,0.5651280692,1533,1427,12,55,1545,1482
444,2.692495898,2.296615928,1399,1337,11,80,1410,1417
786,3.970817697,2.738226596,1302,1229,10,84,1312,1313
324,2.026427947,1.723321101,984,958,8,50,992,1008
685,3.432223913,0.5434518871,1317,1181,10,51,1327,1232
538,3.238942614,0.7842768253,704,704,6,27,710,731
531,2.300052782,0.8468604188,1476,1423,12,68,1488,1491
661,4.979065671,2.166841822,1530,1463,12,102,1542,1565
568,1.223369747,0.7561980303,1204,1166,10,42,1214,1208
775,4.756248348,2.746203139,1480,1340,11,100,1491,1440
601,4.359077705,1.7525262,1283,1194,10,76,1293,1270
771,4.090332514,1.184011465,1268,1176,10,64,1278,1240
576,3.571728395,0.4116295178,1056,1042,9,46,1065,1088
598,1.101454512,0.7992043953,1300,1255,11,46,1311,1301
498,1.188939427,0.4119590299,1301,1239,11,34,1312,1273
762,4.828494465,1.704675198,1480,1397,12,76,1492,1473
351,1.481919959,0.5012456839,1635,1487,13,61,1648,1548
522,4.214269566,0.5514401224,1459,1375,12,61,1471,1436
397,1.85710009,2.001264116,959,816,7,48,966,864
446,3.289641464,2.815251424,876,822,7,55,883,877
631,1.51991167,1.705300652,1545,1391,12,80,1557,1471
693,1.746496951,0.5485696439,1201,1130,10,42,1211,1172
776,4.018050544,1.29454918,1636,1487,13,71,1649,1558
801,2.512607629,1.268635783,997,914,8,45,1005,959
660,2.609848328,2.246052544,898,812,7,52,905,864
481,1.14386221,2.636188782,746,682,6,33,752,715
365,4.029368339,2.794395773,1494,1390,12,93,1506,1483
412,3.880414186,0.3101199384,1259,1120,10,45,1269,1165
556,4.303459598,2.111887991,1451,1397,12,103,1463,1500
683,4.448873972,2.628228399,884,819,7,68,891,887
701,4.311008795,0.371943988,1382,1415,13,32,1395,1447
519,1.078195171,2.848117036,1200,1119,10,57,1210,1176
744,1.704794317,1.047802201,698,665,6,29,704,694
315,1.100667007,1.988296982,579,557,5,28,584,585
626,2.307400508,2.375318623,599,574,5,45,604,619
492,4.275185686,1.096154134,1269,1224,11,65,1280,1289
651,3.387056155,1.329904238,1305,1210,11,54,1316,1264
313,1.401241104,1.921471352,1432,1427,13,70,1445,1497
691,4.311836303,2.824746454,1407,1266,11,116,1418,1382
328,2.081730586,0.342211968,1439,1387,13,40,1452,1427
445,4.201420048,0.1647995144,1584,1501,14,51,1598,1552
471,2.827708304,0.002206106173,1361,1374,13,31,1374,1405
343,3.743581815,0.9823763649,704,660,6,40,710,700
461,4.58467561,2.267387738,1120,1113,10,86,1130,1199
369,3.711298801,0.1228087041,975,950,9,30,984,980
613,1.419248707,1.532902171,875,855,8,38,883,893
618,4.361576785,0.8515054108,914,864,8,47,922,911
537,3.681141177,2.666222035,582,555,5,47,587,602
575,3.77353608,0.9652115135,783,734,7,33,790,767
500,1.668523013,0.729377285,959,943,9,45,968,988
438,2.46895266,0.456627175,917,830,8,32,925,862
760,2.348385629,1.681650989,976,941,9,48,985,989
735,1.277933379,1.256671287,1611,1549,15,62,1626,1611
349,2.251638321,1.368826006,1435,1310,13,55,1448,1365
675,2.055708065,2.627433506,1457,1427,14,84,1471,1511
562,2.429888441,0.7056473915,1292,1302,13,55,1305,1357
374,1.030304672,0.5290234837,1215,1186,12,34,1227,1220
714,2.224977575,2.794166198,692,703,7,39,699,742
383,3.915332951,0.5612796373,711,696,7,34,718,730
718,1.199302479,0.6406361111,1359,1282,13,52,1372,1334
511,3.609313391,0.8183518787,591,595,6,28,597,623
774,4.795561229,1.011719254,678,693,7,33,685,726
758,1.767122399,0.8959434958,925,879,9,32,934,911
702,1.670061547,0.4240068983,1594,1553,16,47,1610,1600
595,3.498601512,0.2674001094,1228,1248,13,41,1241,1289
340,3.318653809,2.915673861,960,890,9,64,969,954
334,2.973597312,2.860704492,1184,1080,11,82,1195,1162
345,1.043851106,0.8268107954,1294,1313,14,42,1308,1355
314,4.887766873,1.428089285,603,569,6,27,609,596
539,4.681140032,2.929815971,1067,978,10,82,1077,1060
770,2.307763348,1.798207396,571,566,6,24,577,590
429,1.148510509,1.151151709,901,842,9,28,910,870
376,3.969761686,0.8555711533,1466,1422,15,71,1481,1493
486,1.639423175,0.6185042437,1405,1403,15,52,1420,1455
790,1.037078545,1.192221521,1493,1382,15,56,1508,1438
398,3.067368065,1.030761697,598,543,6,19,604,562
700,4.674547186,0.0115530374,1347,1345,15,34,1362,1379
668,4.438462977,1.148399294,1203,1193,13,66,1216,1259
385,4.318720567,1.199780303,649,645,7,43,656,688
731,1.00108511,0.1698862472,1074,1069,12,27,1086,1096
732,2.076414052,0.3452442181,1286,1256,14,45,1300,1301
644,3.077049332,0.2226273334,927,982,11,35,938,1017
482,1.82865555,2.329472982,619,545,6,36,625,581
653,4.055344021,2.010760151,1483,1357,15,105,1498,1462
597,1.050990841,0.4028973572,768,787,9,25,777,812
527,4.112964157,2.684723962,617,528,6,25,623,553
425,2.242256054,0.333145378,770,764,9,23,779,787
772,1.226224443,0.9875013335,866,852,10,33,876,885
463,1.034634444,1.030739643,1168,1178,14,36,1182,1214
357,2.022349751,2.547232141,910,844,10,42,920,886
627,1.983576754,0.01281101417,605,575,7,16,612,591
372,2.300769019,0.2298053946,828,731,9,24,837,755
418,1.513362997,0.7436880088,1564,1522,20,53,1584,1575
669,2.790121119,1.147187888,582,517,7,26,589,543
782,2.276788981,0.6257179478,877,891,13,41,890,932
514,4.348934813,1.167314363,769,747,11,31,780,778
741,2.546204749,1.018984195,641,605,9,27,650,632
1035,4.877977063,0.9558402004,674,586,3,25,677,611
1036,1.379857321,1.493989351,1427,1371,8,38,1435,1409
1037,3.174834255,1.834285578,1817,1649,12,70,1829,1719
1038,4.199554524,0.6397999811,1074,1017,1,48,1075,1065
1039,2.470223311,0.6460432964,812,736,4,40,816,776
1040,1.040854407,1.297248691,1581,1467,10,45,1591,1512
1041,2.715362238,2.093825859,666,650,6,32,672,682
1042,4.017781909,2.222772644,1867,1666,7,78,1874,1744
1043,4.026603197,1.03481525,1515,1311,8,52,1523,1363
1044,2.218937258,0.7633056674,845,797,1,32,846,829
1045,2.090963766,1.082367429,969,945,6,35,975,980
1046,3.169968046,2.058496584,1844,1570,7,78,1851,1648
1047,3.088895623,0.5551441177,683,597,2,20,685,617
1048,3.078992781,0.1292594161,1543,1384,5,26,1548,1410
1049,4.689840805,2.823021773,1604,1436,4,73,1608,1509
1050,4.956241075,0.9013748143,1873,1695,3,70,1876,1765
1051,1.292933896,2.081230377,1438,1386,5,53,1443,1439
1052,3.622891707,2.171641308,697,630,2,35,699,665
1053,1.674106454,2.506990696,1493,1389,7,60,1500,1449
1054,4.937920788,1.490777467,707,622,4,34,711,656
1055,3.471714455,1.526605255,1584,1471,3,81,1587,1552
1056,1.249692944,1.358357167,1702,1596,4,81,1706,1677
1057,1.867936724,2.099279129,1445,1359,7,66,1452,1425
1058,2.329120777,2.542701895,1308,1236,7,55,1315,1291
1059,1.208906877,2.794647759,1024,942,6,37,1030,979
1060,1.749650325,0.3291023052,774,720,3,18,777,738
1061,3.565457613,0.618762489,943,836,5,37,948,873
1062,2.837856411,0.2828762183,1676,1579,8,50,1684,1629
1063,4.888959457,1.229242631,913,871,2,40,915,911
1064,2.594542971,2.628630873,781,707,3,32,784,739
1065,2.49484109,0.1396688031,690,614,5,17,695,631
1066,2.559166046,2.865157082,1224,1166,3,87,1227,1253
1067,3.931942357,2.837192509,795,705,6,30,801,735
1068,4.367943893,2.067152849,1028,898,3,63,1031,961
1069,4.062294061,1.180739799,961,857,7,47,968,904
1070,2.14743209,2.139726267,1405,1396,5,65,1410,1461
1071,3.426232104,0.7490651598,1510,1398,7,50,1517,1448
1072,3.169053154,1.344744959,772,796,5,21,777,817
1073,1.934129126,2.726532199,1751,1530,8,85,1759,1615
1074,2.727352972,0.8308408013,1799,1639,6,70,1805,1709
1075,4.533834043,0.4114668915,771,743,3,24,774,767
1076,3.244238802,1.530266847,929,818,7,34,936,852
1077,3.542386975,2.92072402,672,614,4,36,676,650
1078,4.568956437,1.228885414,1365,1276,10,58,1375,1334
1079,2.133229491,0.3167669456,677,613,1,19,678,632
1080,4.383744728,2.679676188,1271,1117,3,72,1274,1189
1081,3.096791257,2.79126878,1016,951,5,46,1021,997
1082,2.995383231,1.691825494,1380,1244,6,44,1386,1288
1083,1.569820167,2.161378671,837,714,5,25,842,739
1084,1.89646471,0.1469242182,1378,1241,4,31,1382,1272
1085,3.678668582,1.843290727,1579,1451,9,76,1588,1527
1086,3.059407827,1.065448499,1596,1508,7,71,1603,1579
1087,3.8442849,2.097979785,1033,997,7,41,1040,1038
1088,4.414614223,0.3755611566,1835,1646,7,49,1842,1695
1089,1.307966733,0.7740780219,1022,982,4,22,1026,1004
1090,2.81850621,2.529166191,927,829,5,39,932,868
1091,3.88387257,0.1552270561,1226,1144,9,31,1235,1175
1092,3.542105251,0.9662264083,1862,1737,6,56,1868,1793
1093,3.774557685,1.313086938,913,818,3,41,916,859
1094,4.66374551,0.3955024857,1141,1060,6,46,1147,1106
1095,2.810704951,0.5908585664,937,815,4,31,941,846
1096,3.715293119,2.911931447,1621,1526,8,107,1629,1633
1097,4.424510504,1.073484135,1466,1338,6,61,1472,1399
1098,3.95798152,1.268692426,1166,1101,6,46,1172,1147
1099,1.522469426,2.102782135,1019,959,2,47,1021,1006
1100,3.30903854,2.661389187,663,675,2,32,665,707
1101,1.046709519,1.655216801,784,769,1,26,785,795
1102,4.113881744,0.5892155217,1722,1575,8,81,1730,1656
1103,3.393758499,0.4088155497,1816,1751,9,82,1825,1833
1104,3.396243696,1.107869577,1364,1288,6,53,1370,1341
1105,3.661693193,2.12717272,698,733,4,38,702,771
1106,1.045875662,0.9044891262,1513,1397,8,38,1521,1435
1107,1.821601834,0.2253710121,691,650,3,18,694,668
1108,2.870631141,1.827153906,1082,915,1,44,1083,959
1109,2.894517699,1.86221947,918,817,5,37,923,854
1110,1.924918627,0.3842171499,697,631,0,25,697,656
1111,2.790844469,2.183614484,1261,1118,5,62,1266,1180
1112,4.330740987,0.2824758744,681,618,2,22,683,640
1113,4.816797113,0.4795622645,1692,1619,10,73,1702,1692
1114,3.214547407,1.391048284,1088,1046,3,46,1091,1092
1115,2.33718774,1.729762015,1050,926,2,35,1052,961
1116,2.452848152,0.2490173076,1306,1178,1,38,1307,1216
1117,2.052676286,1.835432587,1398,1255,9,59,1407,1314
1118,3.437533478,0.634898452,1274,1180,8,50,1282,1230
1119,3.352995547,1.728967296,1004,966,0,57,1004,1023
1120,3.776075022,1.778363237,760,728,2,32,762,760
1121,1.312879223,0.1101737025,1766,1639,13,40,1779,1679
1122,3.873508648,2.354683254,1749,1592,7,89,1756,1681
1123,3.842875966,2.052387133,677,633,4,30,681,663
1124,3.219134798,1.588940112,943,831,2,48,945,879
1125,2.75363686,1.291809264,923,893,2,37,925,930
1126,2.094279913,0.7264770705,1233,1174,8,37,1241,1211
1127,2.723552013,2.529917844,828,781,3,40,831,821
1128,1.009219733,2.753965185,1159,994,9,40,1168,1034
1129,2.713664881,0.1216817653,1388,1245,6,40,1394,1285
1130,3.534612513,1.965935606,677,602,3,31,680,633
1131,2.65542351,1.759791552,887,849,4,34,891,883
1132,4.627509466,2.924950841,1585,1455,4,86,1589,1541
1133,1.134350357,1.708772354,717,672,3,24,720,696
1134,1.931157529,2.54634821,942,824,5,37,947,861
1135,1.172853069,2.775050423,1493,1388,6,48,1499,1436
1136,1.642551544,0.7696922382,1549,1523,13,48,1562,1571
1137,3.062924019,2.897794384,1287,1115,4,60,1291,1175
1138,2.82911458,0.7403403315,1261,1170,6,42,1267,1212
1139,1.091005987,1.481276545,1744,1664,5,60,1749,1724
1140,4.15283549,2.435079342,1124,1061,7,67,1131,1128
1141,2.245817161,0.3245385921,1748,1565,4,52,1752,1617
1142,3.124445286,1.760555572,1444,1342,7,69,1451,1411
1143,1.943175887,2.848657066,1034,936,6,30,1040,966
1144,2.519822734,2.240084502,1804,1657,14,83,1818,1740
1145,2.060669252,0.6816969279,1750,1597,7,48,1757,1645
1146,2.170795937,1.635085551,1424,1331,6,62,1430,1393
1147,3.143997546,1.144334148,907,826,5,36,912,862
1148,3.358271357,0.1093687971,1351,1259,5,43,1356,1302
1149,3.808455466,0.723799377,998,985,3,37,1001,1022
1150,3.117310311,2.0387323,1165,1062,4,54,1169,1116
1151,1.439804611,1.781539652,1385,1292,6,57,1391,1349
1152,3.609169627,1.544700462,1801,1673,8,82,1809,1755
1153,3.14160132,2.906961612,1727,1612,7,77,1734,1689
1154,3.861325673,0.1178237875,1469,1467,3,54,1472,1521
1155,3.152520354,0.8885808411,1557,1378,5,45,1562,1423
1156,2.763520307,2.033421995,1442,1334,4,51,1446,1385
1157,4.156991395,2.291298463,1538,1357,2,68,1540,1425
1158,4.736472453,1.718763183,1770,1697,7,80,1777,1777
1159,3.870147152,1.312073741,1402,1232,4,56,1406,1288
1160,3.2339438,0.758519875,1342,1320,6,39,1348,1359
1161,2.750132912,1.391974553,1631,1491,6,65,1637,1556
1162,2.360258209,0.5735463506,1454,1366,11,48,1465,1414
1163,3.907703322,2.011941716,842,748,6,35,848,783
1164,3.914236381,1.432876875,1677,1635,3,67,1680,1702
1165,4.297288882,1.636937086,1796,1590,6,83,1802,1673
1166,2.997961007,1.800773814,1472,1335,4,82,1476,1417
1167,3.187868226,1.569827146,1594,1618,7,60,1601,1678
1168,3.590238873,0.9199806445,1047,1001,4,39,1051,1040
1169,4.846326917,0.8863640703,1284,1293,8,42,1292,1335
1170,2.582804642,0.4674618728,784,739,2,20,786,759
1171,1.321557728,2.282984288,679,648,2,32,681,680
1172,4.869063638,0.1833597074,1114,1035,5,46,1119,1081
1173,1.408863829,0.6827160234,647,642,8,13,655,655
1174,3.47749096,0.5621204809,998,972,1,44,999,1016
1175,4.807664446,0.6270396664,681,622,1,33,682,655
1176,4.457959514,0.5864698002,1081,994,3,46,1084,1040
1177,3.523809853,0.6082642403,1269,1155,7,51,1276,1206
1178,3.58302563,2.494302404,1684,1578,9,99,1693,1677
1179,1.429641317,0.03777119913,818,719,4,17,822,736
1180,4.559761573,2.247982654,1350,1235,3,80,1353,1315
1181,3.180415547,2.846862679,1471,1361,5,81,1476,1442
1182,2.729284719,2.707776035,1826,1617,15,84,1841,1701
1183,2.04137535,0.09574858076,917,848,2,24,919,872
1184,1.709191552,1.926439604,1864,1701,8,75,1872,1776
1185,2.694428953,0.8436047807,1147,1040,1,40,1148,1080
1186,3.102364721,0.4777157525,1150,1086,5,37,1155,1123
1187,3.914105695,2.819436341,1126,1041,2,62,1128,1103
1188,4.565876179,0.06576241972,1729,1694,10,48,1739,1742
1189,1.911499377,0.4565509679,962,824,5,33,967,857
1190,2.270995993,1.611199479,782,736,3,39,785,775
1191,2.028201932,2.566304725,1757,1539,10,81,1767,1620
1192,2.799009864,1.894972697,960,924,5,48,965,972
1193,1.783807059,1.015775908,1195,1172,5,33,1200,1205
1194,2.036035251,1.113377198,1705,1573,9,54,1714,1627
1195,4.144941931,2.862710687,1457,1300,5,77,1462,1377
1196,2.344051691,2.183930462,1007,906,4,46,1011,952
1197,3.144699528,2.014640926,688,607,5,27,693,634
1198,1.086381031,1.383136326,1489,1389,6,48,1495,1437
1199,3.804546503,1.315223057,1410,1236,2,51,1412,1287
1200,2.349823268,0.1842093937,1863,1729,13,39,1876,1768
1201,4.066303135,0.107266707,674,626,3,24,677,650
1202,4.571545512,2.974425884,1792,1499,4,105,1796,1604
1203,3.704693622,1.029391799,1387,1258,8,49,1395,1307
1204,1.05640694,0.4569350231,766,794,6,20,772,814
1205,3.150640881,0.4805764191,1427,1264,4,62,1431,1326
1206,2.081733726,2.177484595,1835,1660,14,73,1849,1733
1207,2.203210642,0.6618818364,1468,1443,5,44,1473,1487
1208,4.921115171,1.909067987,1117,1024,6,49,1123,1073
1209,4.789205646,0.3617325106,799,759,6,19,805,778
1210,1.157064563,2.242690648,674,609,2,28,676,637
1211,2.263918939,2.184040101,1838,1629,7,86,1845,1715
1212,1.829341384,0.4279623029,875,794,4,25,879,819
1213,2.410563258,2.719910392,795,760,4,28,799,788
1214,1.550548636,1.262343455,767,771,4,22,771,793
1215,2.984221856,0.8517587518,1486,1424,8,55,1494,1479
1216,4.790325949,2.074591988,1637,1464,5,85,1642,1549
1217,1.926564498,1.3671237,1796,1663,6,69,1802,1732
1218,1.072078865,2.650626547,1112,1048,4,49,1116,1097
1219,2.893712118,2.548023585,877,876,2,36,879,912
1220,3.423092306,2.096964591,1471,1390,6,69,1477,1459
1221,4.326805915,2.783279205,1521,1272,5,80,1526,1352
1222,2.957748783,2.832970564,1161,1015,9,56,1170,1071
1223,3.789469161,0.3649628167,930,843,5,31,935,874
1224,3.104904738,1.776748638,832,703,5,46,837,749
1225,3.02452091,0.5643001836,1463,1403,7,37,1470,1440
1226,2.956811218,2.867986818,1727,1700,7,89,1734,1789
1227,4.077231111,0.1127443202,1779,1721,13,54,1792,1775
1228,1.614913417,2.250883578,684,613,4,23,688,636
1229,1.032861801,0.3993522213,1278,1165,7,35,1285,1200
1230,4.823335535,2.915155586,1833,1665,4,100,1837,1765
1231,2.667979376,1.996594203,664,606,3,32,667,638
1232,3.524511111,0.5292412135,1133,1032,5,42,1138,1074
1233,2.894388081,2.058084722,811,728,7,27,818,755
1234,2.173929943,1.623010439,885,826,4,45,889,871
1235,3.005274879,2.751404932,1246,1170,3,50,1249,1220
1236,4.254322238,1.057519689,1172,1064,8,59,1180,1123
1237,1.056880838,2.25136751,824,743,3,26,827,769
1238,1.22455898,2.078146227,893,889,3,28,896,917
1239,1.183686219,1.420276185,764,733,6,29,770,762
1240,3.043148784,0.4850450788,1072,938,4,30,1076,968
1241,3.472297707,2.109555149,805,733,4,35,809,768
1242,1.321381275,2.651194751,1153,1045,8,46,1161,1091
1243,4.214840141,2.730495123,1661,1581,3,101,1664,1682
1244,4.765940757,2.821127151,1716,1503,6,81,1722,1584
1245,4.798370181,2.47959258,1692,1587,6,95,1698,1682
1246,3.995978258,0.8575020131,1355,1269,4,42,1359,1311
1247,4.248062564,1.761731961,1139,1049,4,42,1143,1091
1248,4.031818693,2.643421013,881,873,3,33,884,906
1249,4.278249063,0.7865991593,939,838,2,33,941,871
1250,4.029472981,0.8037465482,892,828,3,37,895,865
1251,4.166476119,1.417123737,1134,1020,4,51,1138,1071
1252,4.622824187,0.6924686966,1245,1161,6,50,1251,1211
1253,2.775816532,1.08402742,1755,1654,7,66,1762,1720
1254,1.083398702,0.7052749566,1054,981,4,23,1058,1004
1255,3.918554821,1.912187041,1813,1650,9,81,1822,1731
1256,2.093670465,2.724604375,1549,1347,9,62,1558,1409
1257,3.628679463,2.22597093,720,731,3,43,723,774
1258,4.067315791,2.893228589,925,821,4,35,929,856
1259,2.471210924,2.60088017,1865,1727,12,71,1877,1798
1260,4.705961461,1.062270711,1876,1660,9,84,1885,1744
1261,4.88174993,2.917445138,1173,1016,4,62,1177,1078
1262,4.345104603,2.957731416,1302,1101,10,71,1312,1172
1263,4.845829111,2.911823928,1645,1557,9,90,1654,1647
1264,2.455139313,0.9578478049,925,849,9,29,934,878
1265,1.228585117,2.47070142,1561,1511,5,58,1566,1569
1266,2.125999593,0.05588332768,1759,1636,8,39,1767,1675
1267,3.429702596,2.33302685,641,654,1,28,642,682
1268,4.612819171,2.39182732,718,610,1,37,719,647
1269,1.0947801,0.3142486988,897,837,2,28,899,865
1270,2.593082558,1.41384935,1580,1445,6,55,1586,1500
1271,3.455004913,0.725650305,1420,1274,8,48,1428,1322
1272,3.771039117,2.259105854,1366,1233,8,73,1374,1306
1273,4.389877492,2.641062477,866,739,4,42,870,781
1274,3.371385778,2.783704344,1149,1109,9,53,1158,1162
1275,4.885649342,0.06962082244,1013,993,2,31,1015,1024
1276,3.939017846,1.689855487,1711,1590,12,75,1723,1665
1277,3.914496814,2.157982465,689,626,2,29,691,655
1278,4.275726996,2.30655511,671,660,1,45,672,705
1279,2.542075566,1.839972839,1779,1535,7,76,1786,1611
1280,2.458901361,0.6673436174,1715,1577,14,50,1729,1627
1281,1.411690072,0.9738866487,1740,1585,2,61,1742,1646
1282,2.369919855,2.15741937,1019,947,8,46,1027,993
1283,3.329228711,2.656993247,1270,1143,4,61,1274,1204
1284,4.142295589,1.141242631,1340,1218,4,65,1344,1283
1285,1.852318507,0.1206230312,1654,1584,10,47,1664,1631
1286,2.46299707,1.40658612,990,982,6,40,996,1022
1287,4.413219075,2.125452504,1107,1120,6,62,1113,1182
1288,4.02643141,0.1940309912,1596,1521,9,47,1605,1568
1289,1.736605053,0.2177744882,1425,1284,6,34,1431,1318
1290,3.913569588,2.110804569,1373,1212,1,63,1374,1275
1291,4.39802337,1.908740135,1854,1625,9,77,1863,1702
1292,2.83727663,2.47482002,1874,1739,7,100,1881,1839
1293,2.17224961,1.865435996,753,711,2,40,755,751
1294,3.923831274,1.528534608,1789,1667,9,86,1798,1753
1295,3.176179584,2.076434598,1454,1395,2,60,1456,1455
1296,1.081747121,2.484044194,1722,1649,16,73,1738,1722
1297,3.445040801,2.657013114,674,626,1,26,675,652
1298,3.357818678,1.323473712,803,738,7,26,810,764
1299,3.541738651,1.716673545,1008,982,9,36,1017,1018
1300,4.270284943,2.332303829,1288,1140,3,63,1291,1203
1301,3.772942849,2.106124906,1564,1464,8,74,1572,1538
1302,4.526518121,0.04734220786,1697,1589,10,36,1707,1625
1303,3.672162417,0.6483850401,1638,1600,3,70,1641,1670
1304,2.115732194,0.9624163498,1305,1155,5,37,1310,1192
1305,3.424759278,0.4726172897,1710,1535,8,59,1718,1594
1306,3.26434987,2.63421847,1473,1341,10,78,1483,1419
1307,3.743430657,2.59684076,1523,1323,7,61,1530,1384
1308,1.385865585,1.722926734,690,632,7,21,697,653
1309,2.302247894,2.843598106,1127,1114,11,54,1138,1168
1310,2.071095039,1.723385694,1785,1535,9,55,1794,1590
1311,2.36663877,2.792167176,884,871,5,43,889,914
1312,2.469091735,0.04351107108,1260,1159,3,31,1263,1190
1313,4.970452622,1.081686006,1117,1073,8,46,1125,1119
1314,4.056273698,0.4208065512,1750,1666,18,73,1768,1739
1315,1.667668708,0.8382459692,1259,1145,3,36,1262,1181
1316,1.243884526,1.389749201,1138,1052,7,37,1145,1089
1317,2.587065273,0.3015456563,1758,1693,7,59,1765,1752
1318,1.936603872,1.758936719,1548,1451,8,65,1556,1516
1319,4.974403267,0.1052667194,1501,1323,9,56,1510,1379
1320,1.800657545,1.466012674,929,830,4,28,933,858
1321,3.280604091,1.088791175,1764,1598,8,60,1772,1658
1322,1.685910814,2.987683788,1367,1276,7,64,1374,1340
1323,4.344866873,1.963647246,694,593,2,38,696,631
1324,4.950041171,0.2261859192,1103,1096,5,36,1108,1132
1325,2.30173618,2.262876864,1724,1584,13,90,1737,1674
1326,1.56722666,1.345056612,1554,1389,8,63,1562,1452
1327,1.380449652,2.847663812,886,799,4,32,890,831
1328,3.629538219,2.026504606,667,631,4,40,671,671
1329,1.539016196,1.975516061,1496,1393,5,59,1501,1452
1330,1.831712101,1.530610461,824,722,2,35,826,757
1331,1.693251457,0.4870368185,1447,1361,8,48,1455,1409
1332,1.321436629,0.1723321416,689,643,1,21,690,664
1333,4.848542684,0.08593359177,1684,1617,8,62,1692,1679
1334,1.706646885,0.3127106329,1341,1181,8,31,1349,1212
1335,3.131914122,2.578230672,800,737,4,45,804,782
1336,1.534391532,2.121910855,893,865,5,29,898,894
1337,3.257964886,1.043982473,1044,954,3,44,1047,998
1338,4.332817315,2.512158825,1510,1339,8,75,1518,1414
1339,2.519340453,2.98547705,1552,1352,5,70,1557,1422
1340,1.311351917,2.22084818,886,821,2,54,888,875
1341,3.709009872,2.61774263,628,603,2,26,630,629
1342,1.423065088,1.053986064,1263,1149,4,34,1267,1183
1343,1.977568523,1.922233679,1634,1580,5,74,1639,1654
1344,3.252221998,0.4509316043,1324,1308,7,56,1331,1364
1345,4.567087254,2.756919882,1800,1648,4,122,1804,1770
1346,2.51652126,1.966474334,1856,1696,9,72,1865,1768
1347,2.634582893,1.741891786,1301,1211,6,62,1307,1273
1348,4.89180199,0.3055697372,1196,1027,12,29,1208,1056
1349,1.991320279,2.648674778,1812,1689,3,72,1815,1761
1350,2.886684179,2.955043968,1680,1567,5,85,1685,1652
1351,4.304780234,1.685845959,648,629,3,37,651,666
1352,3.88966271,2.723574233,1416,1377,4,54,1420,1431
1353,3.153129526,2.370055005,1338,1262,2,62,1340,1324
1354,3.307215129,0.2522249938,937,866,3,28,940,894
1355,1.281431991,1.389453529,1600,1495,7,47,1607,1542
1356,3.592237361,2.920443077,1742,1558,9,97,1751,1655
1357,3.898518116,1.946949084,671,613,1,42,672,655
1358,1.602689771,2.855340158,1504,1352,9,50,1513,1402
1359,2.10421532,1.960262952,1843,1656,4,67,1847,1723
1360,2.71831857,2.3395273,1260,1170,5,56,1265,1226
1361,1.271324712,2.856801682,827,753,5,31,832,784
1362,3.894565316,2.2620979,936,866,6,42,942,908
1363,4.09325409,1.236449323,1866,1668,10,59,1876,1727
1364,2.024166981,0.03261312555,681,631,3,22,684,653
1365,2.619821401,2.784756784,1889,1614,5,93,1894,1707
1366,1.057484766,0.5578982262,1875,1647,11,50,1886,1697
1367,2.267384727,1.659097193,1722,1570,8,46,1730,1616
1368,2.025411572,0.7419256649,1446,1375,4,49,1450,1424
1369,3.397781835,2.038089045,803,747,5,35,808,782
1370,2.627479734,0.4206962903,1065,975,5,29,1070,1004
1371,1.943808591,0.4080844291,682,649,4,15,686,664
1372,4.539451472,2.65089463,1105,1050,4,59,1109,1109
1373,2.344417543,1.157113132,1317,1205,5,47,1322,1252
1374,3.873963184,0.7480069286,1095,1060,5,35,1100,1095
1375,2.075539658,2.813508102,1546,1497,11,72,1557,1569
1376,4.05256878,1.07578486,768,729,1,35,769,764
1377,1.250167764,0.8960145069,1380,1301,9,42,1389,1343
1378,1.129222885,2.40102408,799,746,3,33,802,779
1379,4.815521978,0.7793087739,722,654,2,29,724,683
1380,2.338038025,0.1195116317,1152,1060,7,37,1159,1097
1381,4.355081281,2.195621729,1227,1116,4,57,1231,1173
1382,2.901405129,1.608786611,1747,1527,8,71,1755,1598
1383,1.749450651,1.80574851,922,821,1,37,923,858
1384,1.95135931,2.882193525,1364,1284,7,48,1371,1332
1385,2.865065637,0.9763515801,1254,1180,4,45,1258,1225
1386,2.733885838,2.762046528,1243,1187,6,73,1249,1260
1387,3.115782188,1.666598306,1011,963,3,47,1014,1010
1388,1.358282791,0.9548535752,1322,1238,7,43,1329,1281
1389,1.22645391,2.375537741,819,717,3,35,822,752
1390,3.776857382,1.608849339,1470,1379,6,70,1476,1449
1391,3.521697944,1.827008197,1710,1669,8,89,1718,1758
1392,3.106971962,1.294737766,1140,1150,3,56,1143,1206
1393,2.758492643,2.702962621,908,825,2,38,910,863
1394,3.529999202,1.639489436,1461,1383,8,59,1469,1442
1395,1.41731152,1.128202019,740,616,3,19,743,635
1396,2.903926664,1.674819171,1260,1165,2,61,1262,1226
1397,3.671369125,0.6177666289,1013,991,6,32,1019,1023
1398,3.647085191,1.777082106,927,862,6,43,933,905
1399,1.786036268,0.1905970399,1687,1592,8,38,1695,1630
1400,2.435308873,1.091855489,1614,1490,3,66,1617,1556
1401,4.164527985,1.971514873,772,718,4,40,776,758
1402,4.125263831,0.3498807583,822,715,4,36,826,751
1403,4.303755151,0.2053035255,1528,1332,5,43,1533,1375
1404,4.088273553,1.813213451,807,697,7,44,814,741
1405,2.616714155,0.1795650028,1242,1161,5,42,1247,1203
1406,4.278636408,2.212185334,923,848,2,52,925,900
1407,3.823232646,1.454272142,1273,1145,14,52,1287,1197
1408,4.653865605,0.1848298574,1518,1332,2,38,1520,1370
1409,2.897167966,1.039495159,1822,1661,5,72,1827,1733
1410,3.187271433,2.790940797,1694,1584,6,77,1700,1661
1411,2.327900698,0.3314971514,1214,1142,5,48,1219,1190
1412,4.820416088,0.2018983364,1417,1248,2,52,1419,1300
1413,4.108470811,0.4597272719,990,970,5,33,995,1003
1414,1.168993297,0.3075133649,1513,1355,6,35,1519,1390
1415,3.779971891,1.840455671,1661,1519,10,97,1671,1616
1416,2.055539752,0.2309191587,1627,1576,11,49,1638,1625
1417,1.265325999,2.035460734,1506,1320,8,63,1514,1383
1418,3.791247524,1.515259463,1488,1342,8,61,1496,1403
1419,4.645993899,1.333853694,1889,1701,10,82,1899,1783
1420,2.028073416,0.5127822644,1711,1563,11,54,1722,1617
1421,3.246014295,0.6317332791,1033,904,7,38,1040,942
1422,2.503628112,0.2573917871,1785,1706,9,54,1794,1760
1423,1.466298734,0.8557693465,1859,1663,13,48,1872,1711
1424,4.475918923,1.759599598,1032,905,2,47,1034,952
1425,3.707879275,2.788074348,1401,1328,5,69,1406,1397
1426,4.062567257,0.8965518986,1007,965,6,40,1013,1005
1427,2.156029087,2.480983362,1465,1346,8,67,1473,1413
1428,4.236711365,1.089503488,1392,1269,5,62,1397,1331
1429,1.472600398,1.259964171,1361,1278,9,46,1370,1324
1430,4.82678721,1.694741131,1408,1259,7,76,1415,1335
1431,2.478934345,1.622703806,980,957,7,47,987,1004
1432,4.507744997,0.1598879776,1270,1157,6,47,1276,1204
1433,3.25195907,0.1916689687,767,740,6,16,773,756
1434,3.189667809,1.628087962,726,644,4,34,730,678
1435,1.026679482,0.6271281684,1646,1484,5,51,1651,1535
1436,2.679063088,1.334713721,665,609,4,19,669,628
1437,2.264431569,1.164114647,1838,1525,6,74,1844,1599
1438,2.154240828,0.8775372754,1364,1217,3,55,1367,1272
1439,4.432238265,1.716735658,1679,1573,7,91,1686,1664
1440,2.580766209,2.762044773,1137,1064,2,58,1139,1122
1441,3.367438132,0.8616927937,1531,1423,8,52,1539,1475
1442,2.063241413,1.197758199,915,857,7,36,922,893
1443,1.226620264,2.81245677,1238,1201,5,53,1243,1254
1444,3.784850729,0.2724122352,1830,1649,7,67,1837,1716
1445,1.953937671,1.583802681,1636,1469,4,74,1640,1543
1446,2.852019659,2.130581007,1420,1246,5,73,1425,1319
1447,3.705226951,2.764549636,1419,1271,5,75,1424,1346
1448,1.272613918,2.579120219,883,862,5,28,888,890
1449,3.310928626,1.641539704,1060,980,3,44,1063,1024
1450,1.064384108,2.574037324,908,779,5,37,913,816
1451,2.583245052,2.280418723,1275,1242,8,46,1283,1288
1452,4.398635231,1.191878768,1762,1575,7,83,1769,1658
1453,1.536657028,1.686009256,1141,1017,5,41,1146,1058
1454,1.681954028,1.308895276,1732,1505,5,60,1737,1565
1455,1.983279018,2.536625944,690,658,4,35,694,693
1456,1.715830789,1.601252084,802,739,2,25,804,764
1457,1.157559299,2.588544568,911,811,3,36,914,847
1458,4.51502624,2.819397658,1229,1177,4,55,1233,1232
1459,4.913351306,0.6526317891,1121,1055,4,41,1125,1096
1460,3.408521749,0.0550014063,935,844,5,30,940,874
1461,2.21335039,2.303622103,935,872,3,43,938,915
1462,4.834023878,2.817248517,1107,985,4,63,1111,1048
1463,1.9457442,1.277416812,1482,1390,8,49,1490,1439
1464,4.382424754,2.861674961,887,846,0,35,887,881
1465,4.094814504,2.732618112,1332,1240,9,67,1341,1307
1466,3.556126241,0.4873224434,1176,1022,5,32,1181,1054
1467,2.892492986,0.5076214836,1039,949,1,42,1040,991
1468,2.541452054,0.09587700793,1249,1115,3,35,1252,1150
1469,1.581699816,0.9782284789,1093,1007,4,34,1097,1041
1470,4.629564885,2.237483363,914,808,2,41,916,849
1471,3.686063872,2.656431071,915,850,1,37,916,887
1472,3.83730588,0.6578875337,932,830,4,30,936,860
1473,1.532222112,1.517375163,864,874,7,37,871,911
1474,2.884644427,0.8134550532,1238,1148,5,55,1243,1203
1475,4.870524065,0.3867427021,1199,1058,3,35,1202,1093
1476,4.570912379,0.1655829231,1364,1284,3,43,1367,1327
1477,1.76689443,1.924819713,665,630,4,25,669,655
1478,3.534453263,2.66352355,768,734,3,36,771,770
1479,2.684158028,1.18848911,1845,1644,11,75,1856,1719
1480,1.98394571,0.5758082025,1064,956,3,29,1067,985
1481,2.700504566,0.9529107748,1167,1090,6,37,1173,1127
1482,3.355896525,1.601143658,1471,1348,5,52,1476,1400
1483,2.627318091,0.2177512955,679,664,1,21,680,685
1484,1.040107246,0.4570767944,1166,1038,5,35,1171,1073
1485,2.328502723,1.39117114,1131,1122,7,42,1138,1164
1486,2.810071658,0.3567933407,1383,1262,6,51,1389,1313
1487,4.456611848,0.9619007851,1267,1169,6,63,1273,1232
1488,4.883998783,2.764729968,1777,1675,7,92,1784,1767
1489,2.801791986,0.2746916902,1822,1690,7,78,1829,1768
1490,2.840724896,1.279168488,1430,1364,6,64,1436,1428
1491,2.979795455,2.426617308,1223,1103,8,51,1231,1154
1492,2.471964626,1.556531723,980,940,1,37,981,977
1493,1.973703596,2.682984854,1125,1058,3,52,1128,1110
1494,1.242684206,1.190339711,1684,1575,12,70,1696,1645
1495,4.71318681,2.705749432,1001,875,6,58,1007,933
1496,1.458010344,2.116292445,1320,1122,4,53,1324,1175
1497,4.373304932,1.48533882,1043,974,5,62,1048,1036
1498,3.395517482,1.678942704,1461,1359,7,59,1468,1418
1499,4.349712226,1.214972297,1609,1484,10,75,1619,1559
1500,1.18274081,0.2040308749,1159,1065,6,28,1165,1093
1501,2.491790204,0.7685245243,1719,1630,12,49,1731,1679
1502,4.109457655,1.270082513,930,829,5,37,935,866
1503,2.585543348,1.153690213,879,861,5,28,884,889
1504,2.999939302,2.92749079,1516,1377,6,71,1522,1448
1505,4.514820012,0.05887555619,1920,1699,6,52,1926,1751
1506,2.244484521,2.441912785,913,894,1,30,914,924
1507,4.336859488,0.3253086965,797,723,3,25,800,748
1508,1.865957341,0.4268730515,1707,1631,7,45,1714,1676
1509,1.82374521,0.9009558433,1399,1295,7,43,1406,1338
1510,2.706366154,1.515133895,1515,1354,8,45,1523,1399
1511,3.081182622,1.613694479,1901,1766,11,90,1912,1856
1512,4.739910335,2.683706118,1576,1466,3,86,1579,1552
1513,2.562752319,0.8174645893,848,861,4,38,852,899
1514,1.967648289,0.3505922233,771,760,6,27,777,787
1515,2.54369589,1.964318383,1251,1095,7,48,1258,1143
1516,3.659947123,0.8378372955,1002,951,3,42,1005,993
1517,4.471947172,2.01166871,1046,964,3,46,1049,1010
1518,1.533204522,0.9442118993,819,754,3,18,822,772
1519,3.155404123,2.038709813,907,784,8,33,915,817
1520,3.959548133,2.403907907,819,711,5,41,824,752
1521,1.999631268,0.01766873369,1776,1685,9,42,1785,1727
1522,4.544142839,0.4813725879,1337,1156,1,41,1338,1197
1523,2.973496321,1.595080285,690,600,2,21,692,621
1524,1.937168883,0.01810524566,1439,1434,4,28,1443,1462
1525,3.126804898,2.097811932,1606,1459,9,66,1615,1525
1526,2.560180912,0.8227535574,1797,1647,12,57,1809,1704
1527,4.674786224,0.2257489316,1265,1162,7,37,1272,1199
1528,3.309937194,1.911886129,1468,1373,7,60,1475,1433
1529,3.75352981,1.908248027,1153,1051,3,52,1156,1103
1530,3.868587555,2.942182289,1118,1007,8,54,1126,1061
1531,2.950927302,1.450193997,1862,1746,9,76,1871,1822
1532,3.82138949,0.8484996925,1344,1309,6,52,1350,1361
1533,2.006464057,0.4522523036,841,822,4,33,845,855
1534,3.68197165,1.464653101,1364,1250,8,58,1372,1308
924,3.128357783,0.6071591634,1249,1144,2,46,1251,1190
925,4.962607952,2.18327085,1579,1457,6,105,1585,1562
926,2.931277871,2.462711067,1490,1399,5,87,1495,1486
927,4.377490245,0.7278875927,632,618,2,27,634,645
928,2.269687897,2.370942133,1275,1228,7,65,1282,1293
929,3.046002825,1.720287852,681,616,2,28,683,644
930,4.551785968,2.224943666,1379,1403,4,92,1383,1495
931,2.480479451,2.21680365,770,734,2,33,772,767
932,2.170242001,0.9146415154,1229,1180,4,58,1233,1238
933,2.443907339,1.355755297,1426,1410,6,82,1432,1492
934,3.192035514,1.873836814,1493,1346,6,75,1499,1421
935,2.04173019,1.5488182,783,764,4,33,787,797
936,3.860399522,2.119766842,1208,1116,6,60,1214,1176
937,3.361891203,1.420144431,1401,1308,10,65,1411,1373
938,4.865686548,0.1956106916,666,672,4,32,670,704
939,3.511566074,2.791194785,859,817,1,61,860,878
940,1.640064255,2.080071493,1599,1490,5,85,1604,1575
941,4.096944327,0.580782718,946,938,4,49,950,987
942,4.112553447,0.5339396272,1369,1362,5,57,1374,1419
943,2.729221591,0.4916814121,1044,1057,5,50,1049,1107
944,4.851348053,0.8921073352,797,712,4,31,801,743
945,2.580773395,0.8549284163,1315,1297,5,56,1320,1353
946,1.444310087,2.627243542,1495,1445,4,75,1499,1520
947,2.234699995,1.811925802,1343,1221,5,68,1348,1289
948,2.406196392,0.09241275964,833,863,5,26,838,889
949,2.970574,1.508793694,1624,1485,6,80,1630,1565
950,3.264139167,0.3929247902,1450,1403,8,56,1458,1459
951,3.189850957,1.797166097,1505,1341,8,86,1513,1427
952,3.398580717,1.796679578,1185,1171,5,75,1190,1246
953,2.497406858,1.580642282,1476,1436,8,75,1484,1511
954,1.125240732,1.558828751,1484,1422,8,63,1492,1485
955,2.221859574,2.221317773,1083,1012,4,53,1087,1065
956,2.378689759,1.933901663,1570,1511,8,73,1578,1584
957,3.384753357,0.8028262368,1311,1243,4,62,1315,1305
958,3.060619287,1.844628826,584,559,1,27,585,586
959,1.682737941,0.7914168177,991,924,2,33,993,957
960,2.515559647,2.034251569,1546,1454,5,75,1551,1529
961,1.828776236,1.448653844,1191,1112,7,53,1198,1165
962,3.315325221,0.8573756662,1121,1114,2,47,1123,1161
963,2.64356233,1.576103616,791,755,6,44,797,799
964,1.037233751,0.5960088234,1491,1451,11,52,1502,1503
965,4.416254001,0.4696138657,1307,1234,6,58,1313,1292
966,2.952604484,2.447832472,1410,1311,6,71,1416,1382
967,3.23031489,0.7156859513,1365,1318,6,61,1371,1379
968,1.089591065,0.5340880942,1400,1354,9,50,1409,1404
969,1.474489109,0.9904391557,1331,1311,6,50,1337,1361
970,4.445797015,2.055530932,891,823,2,44,893,867
971,2.870438501,0.5253185737,1470,1446,3,51,1473,1497
972,3.076526355,1.726609944,1481,1404,6,79,1487,1483
973,1.903638456,2.925480279,1079,1035,4,75,1083,1110
974,2.767554903,1.576633962,1130,1171,3,48,1133,1219
975,2.134023333,2.276894017,1407,1344,10,78,1417,1422
976,2.73518318,0.4878979151,913,849,5,35,918,884
977,4.063611443,2.443157279,799,744,3,51,802,795
978,3.239553951,1.838319034,1291,1201,9,69,1300,1270
979,2.766689017,1.051048742,589,534,1,14,590,548
980,4.133702947,2.611386647,1569,1506,3,91,1572,1597
981,1.879062446,0.02760825713,709,666,0,23,709,689
982,4.191049744,2.808071189,1388,1308,6,96,1394,1404
983,2.553205501,0.2368894338,1486,1402,2,43,1488,1445
984,1.18340297,0.4136270588,703,675,2,20,705,695
985,1.40992375,2.143245781,998,948,6,50,1004,998
986,3.370570508,2.499493057,1566,1458,4,77,1570,1535
987,3.10237136,1.923036126,1463,1431,12,70,1475,1501
988,2.141764112,0.8946270916,1614,1516,10,70,1624,1586
989,4.229325353,2.598053467,767,740,3,36,770,776
990,1.344033718,2.34541381,1186,1120,10,49,1196,1169
991,1.922364567,1.739224353,1066,1044,4,54,1070,1098
992,3.778867155,1.026635906,881,816,3,37,884,853
993,4.028991588,0.7240366968,697,649,2,30,699,679
994,2.036440516,1.714326094,1157,1108,3,57,1160,1165
995,4.534518605,1.592694568,1198,1078,4,55,1202,1133
996,4.582142661,0.9678451979,866,844,4,42,870,886
997,3.262414834,2.050134151,908,861,5,53,913,914
998,2.537117799,2.73989912,674,655,4,41,678,696
999,2.02871715,2.94934642,762,707,3,43,765,750
1000,4.851954182,1.979559301,1297,1221,5,81,1302,1302
1001,4.772396681,1.322060604,579,566,1,23,580,589
1002,1.454840544,0.5809838811,1550,1485,12,56,1562,1541
1003,2.528361961,2.850301696,1161,1096,5,63,1166,1159
1004,4.478740423,1.754681003,1451,1416,6,70,1457,1486
1005,2.840128435,2.029949531,1041,1030,3,69,1044,1099
1006,1.095365453,2.003861054,583,604,3,32,586,636
1007,1.96447436,0.8281671214,765,762,4,29,769,791
1008,1.218093155,1.806698534,1558,1514,6,67,1564,1581
1009,1.025234005,2.887366674,1084,1036,8,55,1092,1091
1010,1.101052946,0.1155751303,1538,1605,9,46,1547,1651
1011,1.717359309,2.140721166,885,854,8,50,893,904
1012,4.767789518,1.696703388,732,752,1,47,733,799
1013,3.144096438,2.475323737,902,856,2,49,904,905
1014,1.82537922,2.214937616,785,747,2,32,787,779
1015,2.79970766,1.929761831,934,920,5,55,939,975
1016,1.447386917,1.127440847,1396,1296,9,57,1405,1353
1017,2.681955968,2.10076493,1147,1089,4,69,1151,1158
1018,3.225627304,2.661069991,1236,1237,2,72,1238,1309
1019,1.482468637,1.444228257,804,773,5,24,809,797
1020,4.474244815,0.8362678452,1483,1411,10,55,1493,1466
1021,2.223937152,0.4609237888,1537,1499,12,70,1549,1569
1022,4.210168405,0.2074716777,1104,1017,4,37,1108,1054
1023,4.92551278,2.991717019,1064,1048,4,72,1068,1120
1024,4.57203937,1.195967655,1615,1504,9,95,1624,1599
1025,3.94775772,1.842235249,1303,1225,6,58,1309,1283
1026,1.437748145,2.719915165,1098,1085,2,48,1100,1133
1027,4.106979403,2.942197099,1278,1194,7,86,1285,1280
1028,4.11509858,0.008038927351,922,967,4,35,926,1002
1029,4.964886297,0.8337829254,1060,1013,6,54,1066,1067
1030,3.218977004,1.850429698,900,832,4,50,904,882
1031,3.860261471,2.620889139,724,662,4,39,728,701
1032,1.276474189,0.4953054925,750,748,2,31,752,779
1033,4.487788179,1.230739808,894,812,3,35,897,847
1034,1.9306748,2.523000359,1580,1453,9,89,1589,1542
1035,4.165787333,0.4299215585,863,877,4,45,867,922
1036,2.208029261,0.6983418238,993,926,8,34,1001,960
1037,3.577073767,2.913325491,1185,1138,4,64,1189,1202
1038,1.831970096,0.6753026143,1226,1302,5,43,1231,1345
1039,1.350378672,0.2605321525,1004,976,12,31,1016,1007
1040,3.09314373,1.672734117,1132,1120,5,55,1137,1175
1041,4.920052212,2.927871848,1377,1320,2,90,1379,1410
1042,3.357307634,0.4192434975,1051,1078,4,37,1055,1115
1043,1.236293445,2.342007442,596,584,0,20,596,604
1044,2.755654688,1.842222197,580,563,2,35,582,598
1045,2.569932679,1.624390471,1417,1283,5,59,1422,1342
1046,4.624907843,0.8037077757,1361,1344,5,70,1366,1414
1047,4.252511049,0.4256897241,1485,1482,5,59,1490,1541
1048,4.711260929,2.500443907,1359,1252,3,84,1362,1336
1049,4.715251542,2.970487567,1365,1296,7,94,1372,1390
1050,2.973034243,1.308182739,1062,1045,7,48,1069,1093
1051,1.281022657,1.197094733,685,674,3,17,688,691
1052,1.223143219,1.725472929,860,835,7,42,867,877
1053,2.189089289,0.1059129518,987,997,7,25,994,1022
1054,1.971573827,2.098266093,1009,948,7,44,1016,992
1055,2.879076893,0.1766112098,1263,1249,3,34,1266,1283
1056,1.675105412,1.870157714,566,570,2,28,568,598
1057,4.814933156,1.721851378,792,747,3,40,795,787
1058,4.882931033,0.01671890228,1159,1100,4,31,1163,1131
1059,4.389291541,0.4647447978,685,629,2,26,687,655
1060,4.32780314,1.301031618,1203,1061,3,54,1206,1115
1061,3.30294337,1.230098834,608,583,2,22,610,605
1062,2.108494258,0.1195969572,890,799,9,16,899,815
1063,3.765783771,0.284858693,1175,1158,4,42,1179,1200
1064,4.34812456,0.20799981,655,587,6,20,661,607
1065,1.224928386,0.2117143236,1331,1251,13,37,1344,1288
1066,4.903451013,1.876335318,1282,1217,3,74,1285,1291
1067,1.465548363,2.678365021,1443,1385,8,78,1451,1463
1068,4.031876523,0.8385578151,770,735,2,30,772,765
1069,2.32023782,1.317735018,1384,1326,5,71,1389,1397
1070,1.1320144,0.6037947778,1001,958,2,34,1003,992
1071,2.533631807,1.756934201,786,797,4,38,790,835
1072,1.020161512,2.690696857,1269,1165,7,71,1276,1236
1073,1.426033744,2.081117426,1285,1173,3,61,1288,1234
1074,1.482569686,2.632802266,1503,1387,6,73,1509,1460
1075,3.755944116,1.046919283,577,550,2,31,579,581
1076,4.146144288,0.2016137749,774,791,5,21,779,812
1077,3.404044898,0.708893411,893,846,6,42,899,888
1078,4.871826485,2.052412521,1127,972,6,55,1133,1027
1079,3.434593045,2.7505336,1056,1022,6,68,1062,1090
1080,3.483570843,2.772498483,700,581,4,41,704,622
1081,3.969171738,2.666637194,1349,1359,4,113,1353,1472
1082,2.351284108,1.027843878,1481,1413,13,57,1494,1470
1083,2.408801101,0.6179652836,875,863,3,41,878,904
1084,2.28066707,2.383574328,613,581,2,37,615,618
1085,2.669194793,2.931117627,870,849,4,62,874,911
1086,2.784052068,0.5813832636,1574,1487,7,57,1581,1544
1087,1.999871498,2.171232179,1617,1492,7,84,1624,1576
1088,2.393053076,2.919466406,1636,1500,9,98,1645,1598
1089,2.240189365,0.1916119268,825,747,3,22,828,769
1090,2.900229259,0.8273049239,625,568,3,18,628,586
1091,1.802801197,1.915822991,1188,1111,10,53,1198,1164
1092,1.765544172,2.947072761,1503,1415,6,79,1509,1494
1093,1.93169564,1.817747693,1031,1042,7,38,1038,1080
1094,1.874460581,1.678963066,1316,1187,2,55,1318,1242
1095,3.03585648,1.562130142,768,744,0,42,768,786
1096,4.809922021,2.132892023,1100,1029,1,61,1101,1090
1097,2.541198712,1.128351039,1583,1464,8,77,1591,1541
1098,4.231584558,2.495300588,1537,1417,8,76,1545,1493
1099,2.013844895,0.06755759865,1315,1280,10,40,1325,1320
1100,4.814555442,0.3421744012,808,730,2,25,810,755
1101,2.332116398,2.548806322,607,552,4,30,611,582
1102,4.653058526,2.437721954,902,827,0,46,902,873
1103,2.515632712,0.6668612266,567,608,1,22,568,630
1104,2.929263571,0.6237301159,1194,1196,6,49,1200,1245
1105,4.543520656,0.5119597154,818,747,1,33,819,780
1106,3.626199295,2.631881007,1568,1469,12,89,1580,1558
1107,4.532676025,2.018060908,713,658,0,32,713,690
1108,3.403525091,0.7642319002,1164,1043,3,44,1167,1087
1109,2.295760847,0.7281214155,876,874,5,46,881,920
1110,1.247515194,0.8035048013,1427,1396,13,60,1440,1456
1111,1.966167782,2.307941643,1428,1396,5,81,1433,1477
1112,3.237902001,0.6284502952,1184,1151,8,53,1192,1204
1113,2.932569047,1.210772467,1054,1042,2,49,1056,1091
1114,2.278891315,1.133623198,1149,1161,6,54,1155,1215
1115,4.864782389,0.06746708026,1575,1574,10,42,1585,1616
1116,2.851544812,2.833981794,1124,982,4,68,1128,1050
1117,1.39116649,1.188143826,1196,1168,8,48,1204,1216
1118,4.840200324,1.859790552,764,728,3,57,767,785
1119,4.953318224,2.589599815,623,547,2,41,625,588
1120,2.885285081,2.989287347,1402,1299,6,89,1408,1388
1121,2.669546229,1.460434569,920,817,4,41,924,858
1122,2.244347761,1.095726121,1087,1047,6,41,1093,1088
1123,4.714903891,1.499523159,1124,954,3,51,1127,1005
1124,1.732286958,2.633319598,1001,952,4,57,1005,1009
1125,3.999751587,2.325404533,1519,1391,1,98,1520,1489
1126,1.935935238,2.450518932,1069,983,3,51,1072,1034
1127,4.741342055,0.6628178389,1167,1144,8,42,1175,1186
1128,2.277743825,2.096544425,564,586,0,26,564,612
1129,2.955825519,2.567898773,810,771,4,43,814,814
1130,3.801078851,1.283039202,912,816,3,45,915,861
1131,4.374177342,1.624371173,1427,1377,5,75,1432,1452
1132,4.257940156,0.1136444729,921,873,3,23,924,896
1133,2.395228978,0.4245873881,1600,1567,5,60,1605,1627
1134,4.667663177,2.755684314,1157,1060,6,91,1163,1151
1135,3.044361178,0.9820588518,621,564,5,22,626,586
1136,1.937653814,1.990459275,1448,1387,4,80,1452,1467
1137,3.347298098,2.910717544,1235,1131,5,65,1240,1196
1138,1.009907842,0.887905713,1473,1457,5,52,1478,1509
1139,3.766016081,2.663634993,1111,1042,6,73,1117,1115
1140,1.391916935,2.416945421,1496,1566,9,78,1505,1644
1141,2.217006723,0.7660704386,1248,1253,5,61,1253,1314
1142,2.085884875,1.041236261,1485,1409,5,59,1490,1468
1143,4.99463795,0.5127562422,1018,942,4,42,1022,984
1144,1.975338893,0.7041423418,1616,1591,7,60,1623,1651
1145,3.058876988,1.226853597,589,552,6,27,595,579
1146,2.113350584,2.063620755,1027,927,3,52,1030,979
1147,4.30323509,2.891948411,1105,1072,2,82,1107,1154
1148,4.460123822,1.120038494,632,550,1,33,633,583
1149,3.857192814,0.893501981,1616,1545,5,74,1621,1619
1150,2.725298506,1.164552758,780,737,2,36,782,773
1151,4.946957834,1.051178405,787,717,3,45,790,762
1152,1.66032389,2.113637018,1411,1335,5,68,1416,1403
1153,4.892592841,0.4308507332,1216,1206,2,54,1218,1260
1154,2.594658725,0.7114585522,978,944,6,30,984,974
1155,3.540817946,1.044902069,1031,906,3,39,1034,945
1156,4.570144867,0.4847422323,906,846,3,28,909,874
1157,2.74603019,0.04184170709,599,588,4,20,603,608
1158,3.8620754,2.586173317,1285,1189,4,76,1289,1265
1159,4.887242856,2.258070229,702,670,1,59,703,729
1160,4.270800127,0.07348244572,1225,1109,4,46,1229,1155
1161,2.202020061,0.6723172435,1457,1392,12,44,1469,1436
1162,4.068858357,2.427538754,1161,1134,4,65,1165,1199
1163,4.474983702,2.381635358,1090,1037,1,80,1091,1117
1164,3.968393957,0.9497179157,714,633,2,37,716,670
1165,4.096788734,2.804090598,673,630,0,44,673,674
1166,4.768971402,1.214437493,1362,1318,1,69,1363,1387
1167,4.008906007,2.813411942,1474,1277,2,78,1476,1355
1168,1.651392437,0.732406717,1079,1065,10,40,1089,1105
1169,1.590721562,1.792739012,1573,1558,4,90,1577,1648
1170,2.258710896,0.6101912197,948,901,7,40,955,941
1171,3.586409918,2.825781395,941,910,8,59,949,969
1172,4.144334046,0.3339371162,1495,1485,6,48,1501,1533
1173,4.725248133,2.981341125,1635,1541,5,118,1640,1659
1174,3.199670418,1.372528805,782,736,5,42,787,778
1175,1.933985127,1.771491979,995,957,4,64,999,1021
1176,2.75429087,0.06573600251,1301,1194,7,36,1308,1230
1177,1.301986528,0.1385744802,1074,1061,4,30,1078,1091
1178,2.748859532,2.60408825,1247,1126,7,57,1254,1183
1179,2.009803632,2.356870761,914,839,6,43,920,882
1180,1.212212824,2.127305929,660,695,5,32,665,727
1181,2.849514692,2.036180659,1385,1308,4,84,1389,1392
1182,4.714171915,2.241419881,561,557,5,34,566,591
1183,3.17706776,0.224522477,982,937,4,22,986,959
1184,3.085765028,1.107844905,760,742,3,35,763,777
1185,2.7990718,1.170393002,1503,1472,4,76,1507,1548
1186,3.637504247,1.768392155,658,561,2,36,660,597
1187,4.044068638,1.957999321,883,810,3,57,886,867
1188,4.280768472,0.3847276814,1310,1211,5,55,1315,1266
1189,3.859979207,1.857388709,1150,1120,1,69,1151,1189
1190,3.261304545,0.9921602033,1048,1061,0,55,1048,1116
1191,1.372445261,1.996178828,1097,1064,8,40,1105,1104
1192,3.386975416,0.4586574775,1177,1156,6,54,1183,1210
1193,4.083758007,1.13163135,1474,1439,4,63,1478,1502
1194,1.733601413,2.811458164,653,643,3,47,656,690
1195,3.983964109,2.473179766,786,726,5,59,791,785
1196,1.325861044,0.2032464469,968,1022,4,35,972,1057
1197,2.764091784,1.619594734,664,686,4,35,668,721
1198,4.608541885,0.9947025139,1512,1356,5,71,1517,1427
1199,1.249299481,1.311224527,598,594,3,22,601,616
1200,2.223743225,2.912853809,1404,1301,6,87,1410,1388
1201,4.190530997,0.7851954631,874,892,3,37,877,929
1202,2.387507057,2.185077498,1284,1208,3,68,1287,1276
1203,1.945304778,1.452832401,1466,1428,10,63,1476,1491
1204,2.179132551,1.435569909,1399,1319,4,59,1403,1378
1205,1.330011256,0.89020195,955,949,5,29,960,978
1206,1.846573995,2.746337896,596,602,5,32,601,634
1207,2.608767859,1.210573417,1413,1328,8,70,1421,1398
1208,3.968455918,1.408037187,1104,1045,2,51,1106,1096
1209,4.901044635,1.442664087,899,829,2,62,901,891
1210,2.847670271,1.873409269,752,720,4,35,756,755
1211,4.639450043,2.301756144,1199,1090,3,89,1202,1179
1212,1.44025728,2.483462167,1251,1092,2,61,1253,1153
1213,2.774448966,2.278217887,982,991,2,50,984,1041
1214,2.913187414,2.82169031,675,674,2,48,677,722
1215,3.713619767,2.810086221,1271,1212,5,81,1276,1293
1216,4.931340375,2.852578819,1586,1466,2,100,1588,1566
1217,4.617621937,1.38824533,689,619,3,25,692,644
1218,2.350461216,2.228236572,1076,972,6,49,1082,1021
1219,2.425132423,1.755725989,1341,1301,4,67,1345,1368
1220,4.197436157,1.914444992,757,794,6,32,763,826
1221,2.697174249,0.226005267,908,851,0,26,908,877
1222,1.396772108,2.931229909,1174,1106,4,65,1178,1171
1223,2.796605692,2.534919648,1117,1087,9,60,1126,1147
1224,3.752761869,0.3602189661,1244,1123,6,34,1250,1157
1225,3.177154782,1.373437027,1280,1268,6,65,1286,1333
1226,2.934113551,0.05973120607,1656,1423,10,31,1666,1454
1227,2.450781939,1.021791363,1015,919,2,35,1017,954
1228,2.062347318,0.6830431504,924,855,5,31,929,886
1229,4.694590677,1.135985565,1198,1116,3,72,1201,1188
1230,4.042450899,2.518490342,1173,1162,3,68,1176,1230
1231,2.99707389,0.2097388223,939,978,6,27,945,1005
1232,3.154541208,1.727441489,1473,1448,5,67,1478,1515
1233,1.674653498,2.294228613,1272,1286,8,65,1280,1351
1234,1.717894398,2.237806333,892,830,4,37,896,867
1235,4.151727674,1.598256726,1219,1192,4,63,1223,1255
1236,1.004122079,2.386864978,1254,1209,9,52,1263,1261
1237,1.007864623,0.1538436626,828,772,4,24,832,796
1238,1.875324588,0.2902267003,664,661,2,23,666,684
1239,2.656405808,2.526870731,1240,1200,5,58,1245,1258
1240,3.752010887,0.08068949961,899,859,5,39,904,898
1241,4.322769042,1.910726406,1031,937,3,36,1034,973
1242,1.005189725,0.7336642724,856,835,8,31,864,866
1243,2.399023341,0.4268631124,1578,1569,11,57,1589,1626
1244,1.033832177,2.725509806,994,985,3,61,997,1046
1245,3.174143607,2.432053815,811,761,5,41,816,802
1246,4.374159229,0.2706141037,1396,1366,5,62,1401,1428
1247,4.595365299,0.1786657226,1147,1130,4,36,1151,1166
1248,2.336304757,1.089294188,975,950,3,42,978,992
1249,4.881187363,0.9323435826,1323,1228,6,54,1329,1282
1250,1.110569664,1.409960637,1125,1201,4,43,1129,1244
1251,4.84098576,2.409384262,696,653,4,40,700,693
1252,4.662096028,2.143781293,1299,1221,5,65,1304,1286
1253,2.347911585,0.1495940475,575,568,3,25,578,593
1254,2.150588421,1.666445375,1385,1302,9,63,1394,1365
1255,2.300542727,0.349949183,1469,1412,0,59,1469,1471
1256,4.500863244,2.600314334,655,678,1,49,656,727
1257,3.239388244,1.36372074,1609,1519,8,80,1617,1599
1258,2.069871125,1.537006588,1413,1390,7,63,1420,1453
1259,1.03954176,1.136624978,1170,1095,9,35,1179,1130
1260,3.075713173,1.619197242,667,657,4,30,671,687
1261,4.049749249,1.025759077,864,760,3,49,867,809
1262,2.091196127,0.0407292978,1037,1060,7,39,1044,1099
1263,1.956287689,2.041894949,783,770,6,43,789,813
1264,1.454537771,1.037447056,1317,1269,12,51,1329,1320
1265,3.283165051,1.257969064,1173,1112,5,65,1178,1177
1266,1.007203847,2.882546846,578,558,3,29,581,587
1267,3.637759857,1.64527712,1017,902,3,50,1020,952
1268,1.946578433,1.36565158,1608,1580,9,69,1617,1649
1269,3.186531096,1.41387576,1398,1288,3,68,1401,1356
1270,3.718079437,0.8618328749,1228,1211,14,46,1242,1257
1271,1.424172143,0.2197841358,1092,1060,10,29,1102,1089
1272,3.960526558,0.05101436271,1279,1247,6,49,1285,1296
1273,2.498227563,0.1684179158,802,805,1,24,803,829
1274,3.163100945,0.4990021122,1008,1027,8,43,1016,1070
1275,1.827732672,1.887122625,957,933,6,44,963,977
1276,4.907100685,0.05775079945,1440,1450,11,66,1451,1516
1277,2.380153251,2.409933337,1122,1075,2,74,1124,1149
1278,2.798966271,0.09099895588,583,599,0,23,583,622
1279,4.271179506,2.951549891,550,565,1,35,551,600
1280,1.469665796,2.662821097,1137,992,4,47,1141,1039
1281,2.939534732,2.166615795,1509,1458,6,70,1515,1528
1282,3.64552811,1.809423896,618,579,3,20,621,599
1283,1.580957084,2.221713241,1280,1366,7,62,1287,1428
1284,2.81932416,2.76356785,955,972,6,55,961,1027
1285,1.878225011,2.653175136,1179,1149,5,68,1184,1217
1286,4.484630889,0.6987822729,785,768,3,32,788,800
1287,3.342710327,1.280582493,871,793,1,48,872,841
1288,4.611902978,1.348953389,601,504,4,26,605,530
1289,2.226672935,0.7660772448,826,797,4,26,830,823
1290,3.838708883,2.856694647,1462,1353,3,100,1465,1453
1291,2.521546163,2.004142842,881,847,4,39,885,886
1292,1.337295939,1.81064396,1095,998,3,45,1098,1043
1293,2.750918854,1.944489124,1186,1221,7,56,1193,1277
1294,3.557631888,0.7847470853,1589,1494,4,62,1593,1556
1295,4.030999629,1.560764461,1277,1285,6,69,1283,1354
1296,2.879417356,0.7768521219,1564,1523,2,64,1566,1587
1297,3.741427563,0.5217602694,1384,1319,6,64,1390,1383
1298,4.743712065,0.7671099598,718,632,4,32,722,664
1299,4.498170588,0.5643347341,1559,1490,6,67,1565,1557
1300,4.373443902,1.781605095,679,637,1,33,680,670
1301,4.150207357,0.1703411221,1429,1363,6,57,1435,1420
1302,3.352228484,0.4627107681,800,771,8,35,808,806
1303,1.467365697,1.052274477,1179,1133,5,62,1184,1195
1304,2.929667541,2.865081581,585,567,1,36,586,603
1305,1.387738046,1.838896633,1494,1429,9,71,1503,1500
1306,2.599215011,0.8058493288,1112,1079,3,41,1115,1120
1307,3.890657241,0.8579595813,1028,1033,2,52,1030,1085
1308,2.835196022,1.586215198,1153,1121,6,60,1159,1181
1309,3.285121168,0.9730844844,701,642,2,34,703,676
1310,2.140926135,0.1628721632,731,657,6,26,737,683
1311,3.118825579,0.09269811133,1422,1328,7,48,1429,1376
1312,1.969375761,2.191981419,1203,1097,8,57,1211,1154
1313,1.280165357,0.1524643117,1562,1607,7,46,1569,1653
1314,4.944122348,0.8311986827,1495,1405,5,76,1500,1481
1315,1.668461533,1.381353112,563,574,1,20,564,594
1316,3.268154051,2.011566894,982,950,3,51,985,1001
1317,4.468504659,0.60776604,1119,1111,4,43,1123,1154
1318,4.762203437,1.498434681,1546,1519,12,78,1558,1597
1319,2.803842562,2.91008834,1478,1468,11,97,1489,1565
1320,2.762847898,0.7565502517,1587,1547,5,71,1592,1618
1321,4.86574314,1.768950746,852,845,2,50,854,895
1322,1.641506992,0.5353400299,985,963,4,32,989,995
1323,2.391025301,1.499732232,1478,1425,2,70,1480,1495
1324,4.829014047,0.5564432596,1619,1568,5,65,1624,1633
1325,4.228483437,2.502768643,700,653,5,34,705,687
1326,4.973608701,2.283767913,535,540,2,29,537,569
1327,4.515069815,1.103042417,1463,1414,6,74,1469,1488
1328,1.993898128,1.466405394,1199,1097,4,65,1203,1162
1329,1.279530296,2.448613792,1498,1379,6,73,1504,1452
1330,2.036625017,1.166544179,552,578,3,24,555,602
1331,1.874019334,0.7892883252,1390,1290,9,60,1399,1350
1332,1.385376907,1.792335898,1440,1316,5,51,1445,1367
1333,3.342321556,0.2118846861,1560,1537,7,64,1567,1601
1334,3.703257631,2.291104678,1105,991,3,53,1108,1044
1335,4.222607738,2.291850962,1209,1165,6,66,1215,1231
1336,1.47593263,1.496692511,894,841,4,39,898,880
1337,1.65119137,1.121553983,994,972,11,42,1005,1014
1338,1.851336318,0.3146095129,788,800,2,26,790,826
1339,3.941611023,2.463855296,891,824,4,61,895,885
1340,2.714513097,0.2950270247,863,895,2,30,865,925
1341,4.013410556,0.4569309386,877,846,3,35,880,881
1342,2.845619985,2.470339074,1224,1243,4,71,1228,1314
1343,4.368524877,2.124513067,893,786,1,50,894,836
1344,1.807420368,2.081524402,1093,1042,4,66,1097,1108
1345,3.2421854,1.04331787,788,750,4,36,792,786
1346,2.689053806,0.0891650506,954,961,3,29,957,990
1347,1.741707109,2.311802433,1231,1098,1,47,1232,1145
1348,4.921195165,0.8580099373,1617,1564,11,87,1628,1651
1349,4.775766869,1.375703727,870,812,4,51,874,863
1350,2.550842474,2.334145796,1350,1268,4,80,1354,1348
1351,3.955459417,2.554965373,847,847,4,65,851,912
1352,3.92070844,0.3553474763,1240,1257,5,54,1245,1311
1353,4.864723305,2.780917519,579,626,5,43,584,669
1354,1.678339785,1.063916424,788,711,7,26,795,737
1355,1.653128151,0.8143071177,591,554,5,28,596,582
1356,2.086609553,1.479691393,696,695,5,29,701,724
1357,1.569195573,1.076453246,924,887,6,35,930,922
1358,1.179607638,1.16378331,1631,1571,9,57,1640,1628
1359,2.677821713,1.260080987,1223,1177,4,62,1227,1239
1360,2.879027553,2.123868057,1299,1131,1,71,1300,1202
1361,2.517679018,1.271645211,1573,1509,10,78,1583,1587
1362,3.831426819,1.646236603,681,670,4,44,685,714
1363,1.284848519,1.267708397,581,564,2,20,583,584
1364,3.301154853,1.474850476,575,566,4,31,579,597
1365,4.318789759,2.142890657,948,897,2,65,950,962
1366,1.646693833,2.032013314,728,691,4,29,732,720
1367,4.839692509,2.518912359,1501,1367,9,91,1510,1458
1368,3.392828959,0.3438586055,684,634,6,24,690,658
1369,4.361188553,1.680881105,923,862,1,53,924,915
1370,3.64805659,0.4523107753,1512,1474,10,61,1522,1535
1371,4.70416318,1.314896818,869,810,3,39,872,849
1372,3.939407721,2.423928339,1189,1132,7,60,1196,1192
1373,3.441257257,0.7003856542,758,737,3,41,761,778
1374,4.476862056,2.107681365,1083,1050,2,49,1085,1099
1375,2.684033985,2.311839859,1552,1433,2,72,1554,1505
1376,1.301020444,2.285067859,1270,1217,4,43,1274,1260
1377,4.416337322,0.8589949146,1200,1109,6,50,1206,1159
1378,4.570634918,2.048632805,976,956,3,45,979,1001
1379,1.463392588,1.353482091,1493,1429,8,58,1501,1487
1380,4.298885468,0.4273378212,1604,1601,4,66,1608,1667
1381,1.227992889,1.32537571,1280,1312,4,48,1284,1360
1382,2.647109541,2.076133502,934,827,7,40,941,867
1383,1.194878956,0.1855584734,1150,1116,6,33,1156,1149
1384,2.318428566,1.062754965,701,685,3,26,704,711
1385,1.781890325,1.068020082,655,675,8,23,663,698
1386,1.6108798,2.425700562,686,701,4,37,690,738
1387,1.146730284,2.122416408,1475,1456,9,62,1484,1518
1388,2.346778268,0.7620578493,995,977,9,35,1004,1012
1389,2.877796617,1.594746257,1628,1500,3,82,1631,1582
1390,3.601768757,0.5992036088,604,549,2,24,606,573
1391,4.913088707,1.775926383,652,538,2,29,654,567
1392,3.545855886,2.444779475,1091,1048,5,64,1096,1112
1393,3.163172399,2.991899107,791,728,4,38,795,766
1394,3.251921484,0.4868281562,1063,1072,2,43,1065,1115
1395,3.390433232,2.659217347,1175,1126,5,59,1180,1185
1396,3.919283687,2.952053534,1120,1039,4,82,1124,1121
1397,1.537761428,0.1966617107,1215,1114,2,33,1217,1147
1398,4.841021014,1.362453212,1415,1317,5,82,1420,1399
1399,1.869272605,0.485219439,780,780,3,15,783,795
1400,4.052231277,1.381563798,611,586,3,28,614,614
1401,3.279710189,1.807279257,1399,1294,4,77,1403,1371
1402,2.836401363,2.516794392,1262,1160,8,64,1270,1224
1403,3.78463495,0.9913348429,1259,1195,7,51,1266,1246
1404,2.398521875,1.012044006,1479,1402,9,68,1488,1470
1405,3.900086668,0.1561212302,1063,1006,3,44,1066,1050
1406,3.28466603,0.6489386937,737,755,1,41,738,796
1407,3.802888999,1.04528438,613,571,6,30,619,601
1408,2.01464448,0.8318386691,1147,1075,8,38,1155,1113
1409,3.346703721,0.29453137,1540,1514,6,56,1546,1570
1410,2.010104835,2.919284741,851,857,4,49,855,906
1411,2.922451265,2.877388974,960,960,6,59,966,1019
1412,3.520372657,0.4330573313,1269,1222,6,56,1275,1278
1413,3.662740231,2.779662721,1181,1100,5,73,1186,1173
1414,3.137478141,0.2321945796,682,646,0,23,682,669
1415,2.146662209,1.241816328,762,767,1,43,763,810
1416,3.370119344,0.6751466432,1184,1155,5,51,1189,1206
1417,1.796657053,2.472097628,575,549,2,26,577,575
1418,1.113126494,1.57804066,691,658,4,27,695,685
1419,2.97407762,0.9984426298,1440,1399,8,64,1448,1463
1420,1.127023547,0.8401088901,786,749,6,26,792,775
1421,2.592247079,0.1719423808,1491,1395,9,53,1500,1448
1422,4.612652043,2.731227295,1179,1133,3,86,1182,1219
1423,2.080479427,0.2056763596,1212,1166,9,37,1221,1203
